locationA,locationB,avg_purchase_to_delivery_days,avg_carrier_to_delivery_days,on_time_delivery,late_delivery,on_time_carrier,late_carrier,punctuality_ratio,total_successful_deliveries
Amnat Charoen,Amnat Charoen,11.941176470588236,8.235294117647058,32,2,33,1,0.9411764705882353,34
Amnat Charoen,Ang Thong,8.441176470588236,6.235294117647059,32,2,33,1,0.9411764705882353,34
Amnat Charoen,Bangkok,10.909090909090908,8.193181818181818,78,10,80,8,0.8863636363636364,88
Amnat Charoen,Bueng Kan,13.425,10.375,34,6,32,8,0.85,40
Amnat Charoen,Buri Ram,12.347826086956522,9.293478260869565,89,3,88,4,0.967391304347826,92
Amnat Charoen,Chachoengsao,14.487179487179487,10.803418803418804,104,13,102,15,0.8888888888888888,117
Amnat Charoen,Chai Nat,10.122448979591837,7.653061224489796,45,4,46,3,0.9183673469387755,49
Amnat Charoen,Chaiyaphum,12.51063829787234,9.148936170212766,46,1,44,3,0.9787234042553191,47
Amnat Charoen,Chanthaburi,10.957446808510639,8.404255319148936,43,4,44,3,0.9148936170212766,47
Amnat Charoen,Chiang Mai,14.99090909090909,9.536363636363637,97,13,97,13,0.8818181818181818,110
Amnat Charoen,Chon Buri,11.087719298245615,7.649122807017544,53,4,54,3,0.9298245614035088,57
Amnat Charoen,Chumphon,6.545454545454546,4.636363636363637,11,0,10,1,1.0,11
Amnat Charoen,Kalasin,12.240384615384615,9.365384615384615,95,9,98,6,0.9134615384615384,104
Amnat Charoen,Kamphaeng Phet,15.409090909090908,8.5,20,2,19,3,0.9090909090909091,22
Amnat Charoen,Kanchanaburi,4.0,3.0,3,0,3,0,1.0,3
Amnat Charoen,Khon Kaen,15.0,11.407407407407407,49,5,50,4,0.9074074074074074,54
Amnat Charoen,Krabi,14.666666666666666,12.666666666666666,3,0,3,0,1.0,3
Amnat Charoen,Lampang,14.064516129032258,9.67741935483871,29,2,27,4,0.9354838709677419,31
Amnat Charoen,Lamphun,17.238095238095237,11.666666666666666,19,2,19,2,0.9047619047619048,21
Amnat Charoen,Loei,11.787878787878787,8.727272727272727,31,2,32,1,0.9393939393939394,33
Amnat Charoen,Lop Buri,12.189655172413794,9.017241379310345,52,6,52,6,0.896551724137931,58
Amnat Charoen,Maha Sarakham,11.55056179775281,8.707865168539326,80,9,76,13,0.898876404494382,89
Amnat Charoen,Mukdahan,10.261904761904763,7.738095238095238,41,1,40,2,0.9761904761904762,42
Amnat Charoen,Nakhon Nayok,8.785714285714286,5.178571428571429,25,3,22,6,0.8928571428571429,28
Amnat Charoen,Nakhon Pathom,8.416666666666666,6.083333333333333,12,0,11,1,1.0,12
Amnat Charoen,Nakhon Phanom,10.795918367346939,7.989795918367347,98,0,92,6,1.0,98
Amnat Charoen,Nakhon Ratchasima,11.064102564102564,7.634615384615385,151,5,143,13,0.967948717948718,156
Amnat Charoen,Nakhon Sawan,12.4,8.6,5,0,4,1,1.0,5
Amnat Charoen,Nakhon Si Thammarat,10.3,7.0,10,0,9,1,1.0,10
Amnat Charoen,Narathiwat,40.0,29.5,1,1,2,0,0.5,2
Amnat Charoen,Nong Khai,13.05,9.15,19,1,18,2,0.95,20
Amnat Charoen,Nonthaburi,8.9375,5.0625,16,0,13,3,1.0,16
Amnat Charoen,Pathum Thani,14.866666666666667,11.366666666666667,26,4,28,2,0.8666666666666667,30
Amnat Charoen,Pattani,8.52,6.56,24,1,25,0,0.96,25
Amnat Charoen,Phangnga,10.0,5.0,1,0,0,1,1.0,1
Amnat Charoen,Phatthalung,6.375,4.25,8,0,8,0,1.0,8
Amnat Charoen,Phetchaburi,11.333333333333334,5.0,3,0,3,0,1.0,3
Amnat Charoen,Phra Nakhon Si Ayutthaya,14.25,8.692307692307692,45,7,43,9,0.8653846153846154,52
Amnat Charoen,Phrae,13.2,10.8,5,0,5,0,1.0,5
Amnat Charoen,Phuket,7.0,6.0,1,0,1,0,1.0,1
Amnat Charoen,Prachin Buri,12.308823529411764,9.014705882352942,62,6,64,4,0.9117647058823529,68
Amnat Charoen,Prachuap Khiri Khan,11.454545454545455,7.545454545454546,11,0,9,2,1.0,11
Amnat Charoen,Ranong,7.285714285714286,4.857142857142857,7,0,6,1,1.0,7
Amnat Charoen,Ratchaburi,9.125,5.625,8,0,6,2,1.0,8
Amnat Charoen,Rayong,10.96774193548387,8.64516129032258,28,3,30,1,0.9032258064516129,31
Amnat Charoen,Roi Et,13.186746987951807,9.55421686746988,148,18,152,14,0.891566265060241,166
Amnat Charoen,Sa Kaeo,10.827586206896552,8.03448275862069,28,1,29,0,0.9655172413793104,29
Amnat Charoen,Sakon Nakhon,12.545454545454545,8.527272727272727,99,11,94,16,0.9,110
Amnat Charoen,Samut Prakan,11.037037037037036,8.88888888888889,25,2,26,1,0.9259259259259259,27
Amnat Charoen,Samut Sakhon,13.714285714285714,7.142857142857143,7,0,7,0,1.0,7
Amnat Charoen,Samut Songkhram,7.333333333333333,4.266666666666667,15,0,13,2,1.0,15
Amnat Charoen,Saraburi,11.96774193548387,9.193548387096774,85,8,87,6,0.9139784946236559,93
Amnat Charoen,Satun,18.666666666666668,15.166666666666666,3,3,6,0,0.5,6
Amnat Charoen,Si Sa Ket,12.171875,9.2578125,351,33,347,37,0.9140625,384
Amnat Charoen,Sing Buri,14.875,11.125,20,4,21,3,0.8333333333333334,24
Amnat Charoen,Songkhla,8.727272727272727,6.181818181818182,9,2,11,0,0.8181818181818182,11
Amnat Charoen,Sukhothai,14.0,4.25,4,0,4,0,1.0,4
Amnat Charoen,Suphan Buri,10.0,8.5,4,0,4,0,1.0,4
Amnat Charoen,Surat Thani,27.5,25.75,3,1,4,0,0.75,4
Amnat Charoen,Surin,13.193548387096774,10.225806451612904,169,17,176,10,0.9086021505376344,186
Amnat Charoen,Tak,8.25,4.25,4,0,3,1,1.0,4
Amnat Charoen,Trang,8.666666666666666,3.3333333333333335,3,0,3,0,1.0,3
Amnat Charoen,Trat,12.766666666666667,9.583333333333334,50,10,53,7,0.8333333333333334,60
Amnat Charoen,Ubon Ratchathani,10.658333333333333,7.733333333333333,112,8,114,6,0.9333333333333333,120
Amnat Charoen,Udon Thani,12.879310344827585,8.293103448275861,55,3,51,7,0.9482758620689655,58
Amnat Charoen,Uthai Thani,11.166666666666666,7.5,6,0,6,0,1.0,6
Amnat Charoen,Uttaradit,14.416666666666666,10.916666666666666,11,1,12,0,0.9166666666666666,12
Amnat Charoen,Yala,15.0,7.0,1,0,0,1,1.0,1
Amnat Charoen,Yasothon,9.307692307692308,6.769230769230769,48,4,51,1,0.9230769230769231,52
Ang Thong,Ang Thong,4.0,4.0,1,0,1,0,1.0,1
Ang Thong,Bangkok,9.0,6.294117647058823,16,1,16,1,0.9411764705882353,17
Ang Thong,Bueng Kan,12.285714285714286,8.892857142857142,23,5,21,7,0.8214285714285714,28
Ang Thong,Buri Ram,11.168831168831169,6.87012987012987,76,1,76,1,0.987012987012987,77
Ang Thong,Chachoengsao,11.840579710144928,7.898550724637682,66,3,61,8,0.9565217391304348,69
Ang Thong,Chai Nat,8.0,6.636363636363637,10,1,11,0,0.9090909090909091,11
Ang Thong,Chaiyaphum,10.463414634146341,7.512195121951219,39,2,37,4,0.9512195121951219,41
Ang Thong,Chanthaburi,10.708333333333334,7.166666666666667,24,0,20,4,1.0,24
Ang Thong,Chiang Mai,12.346153846153847,7.576923076923077,49,3,49,3,0.9423076923076923,52
Ang Thong,Chon Buri,10.875,8.3125,30,2,31,1,0.9375,32
Ang Thong,Chumphon,14.052631578947368,11.210526315789474,16,3,18,1,0.8421052631578947,19
Ang Thong,Kalasin,11.984615384615385,8.246153846153845,59,6,60,5,0.9076923076923077,65
Ang Thong,Kamphaeng Phet,7.5,4.4,29,1,28,2,0.9666666666666667,30
Ang Thong,Kanchanaburi,11.9,8.4,8,2,8,2,0.8,10
Ang Thong,Khon Kaen,11.066666666666666,8.4,29,1,29,1,0.9666666666666667,30
Ang Thong,Krabi,13.090909090909092,10.272727272727273,10,1,10,1,0.9090909090909091,11
Ang Thong,Lampang,10.0,7.586206896551724,28,1,29,0,0.9655172413793104,29
Ang Thong,Lamphun,14.64,9.56,21,4,17,8,0.84,25
Ang Thong,Loei,11.583333333333334,7.0,11,1,10,2,0.9166666666666666,12
Ang Thong,Lop Buri,10.818181818181818,7.636363636363637,10,1,10,1,0.9090909090909091,11
Ang Thong,Maha Sarakham,11.696969696969697,8.621212121212121,59,7,58,8,0.8939393939393939,66
Ang Thong,Mukdahan,11.095238095238095,8.095238095238095,39,3,42,0,0.9285714285714286,42
Ang Thong,Nakhon Nayok,11.655172413793103,8.10344827586207,25,4,26,3,0.8620689655172413,29
Ang Thong,Nakhon Pathom,10.764705882352942,7.882352941176471,15,2,15,2,0.8823529411764706,17
Ang Thong,Nakhon Phanom,8.493333333333334,5.573333333333333,73,2,64,11,0.9733333333333334,75
Ang Thong,Nakhon Ratchasima,9.460992907801419,6.865248226950355,134,7,133,8,0.950354609929078,141
Ang Thong,Nakhon Sawan,11.130434782608695,7.608695652173913,21,2,20,3,0.9130434782608695,23
Ang Thong,Nakhon Si Thammarat,10.666666666666666,8.133333333333333,14,1,15,0,0.9333333333333333,15
Ang Thong,Narathiwat,14.0,8.777777777777779,9,0,9,0,1.0,9
Ang Thong,Nong Khai,12.076923076923077,8.23076923076923,12,1,13,0,0.9230769230769231,13
Ang Thong,Nonthaburi,10.923076923076923,8.153846153846153,12,1,13,0,0.9230769230769231,13
Ang Thong,Pathum Thani,8.375,6.25,8,0,8,0,1.0,8
Ang Thong,Pattani,13.741935483870968,8.870967741935484,26,5,28,3,0.8387096774193549,31
Ang Thong,Phangnga,11.0,5.5,4,0,4,0,1.0,4
Ang Thong,Phatthalung,5.25,2.375,8,0,7,1,1.0,8
Ang Thong,Phetchaburi,8.772727272727273,5.0,21,1,19,3,0.9545454545454546,22
Ang Thong,Phra Nakhon Si Ayutthaya,11.75,4.5,4,0,4,0,1.0,4
Ang Thong,Phrae,12.272727272727273,7.2727272727272725,11,0,11,0,1.0,11
Ang Thong,Phuket,14.0,11.333333333333334,3,0,3,0,1.0,3
Ang Thong,Prachin Buri,12.91304347826087,8.717391304347826,43,3,39,7,0.9347826086956522,46
Ang Thong,Prachuap Khiri Khan,12.846153846153847,9.615384615384615,11,2,11,2,0.8461538461538461,13
Ang Thong,Ranong,9.076923076923077,5.153846153846154,13,0,11,2,1.0,13
Ang Thong,Ratchaburi,10.555555555555555,7.555555555555555,17,1,17,1,0.9444444444444444,18
Ang Thong,Rayong,14.75,11.85,19,1,17,3,0.95,20
Ang Thong,Roi Et,11.365853658536585,7.951219512195122,114,9,111,12,0.926829268292683,123
Ang Thong,Sa Kaeo,10.742857142857142,7.428571428571429,34,1,29,6,0.9714285714285714,35
Ang Thong,Sakon Nakhon,11.670731707317072,7.475609756097561,80,2,74,8,0.975609756097561,82
Ang Thong,Samut Prakan,12.176470588235293,7.705882352941177,17,0,13,4,1.0,17
Ang Thong,Samut Sakhon,5.666666666666667,2.8333333333333335,6,0,6,0,1.0,6
Ang Thong,Samut Songkhram,12.846153846153847,8.153846153846153,12,1,9,4,0.9230769230769231,13
Ang Thong,Saraburi,14.277777777777779,11.61111111111111,16,2,18,0,0.8888888888888888,18
Ang Thong,Satun,13.625,6.875,8,0,5,3,1.0,8
Ang Thong,Si Sa Ket,11.75,8.294642857142858,101,11,98,14,0.9017857142857143,112
Ang Thong,Sing Buri,16.666666666666668,9.5,5,1,5,1,0.8333333333333334,6
Ang Thong,Songkhla,10.6,6.7,20,0,17,3,1.0,20
Ang Thong,Sukhothai,9.0,6.0,4,0,3,1,1.0,4
Ang Thong,Suphan Buri,12.0,10.666666666666666,2,1,3,0,0.6666666666666666,3
Ang Thong,Surat Thani,18.857142857142858,10.428571428571429,6,1,6,1,0.8571428571428571,7
Ang Thong,Surin,10.986301369863014,8.219178082191782,67,6,67,6,0.9178082191780822,73
Ang Thong,Tak,13.454545454545455,8.636363636363637,11,0,10,1,1.0,11
Ang Thong,Trang,3.0,2.0,1,0,1,0,1.0,1
Ang Thong,Trat,12.518518518518519,8.814814814814815,24,3,23,4,0.8888888888888888,27
Ang Thong,Ubon Ratchathani,10.811111111111112,8.333333333333334,88,2,86,4,0.9777777777777777,90
Ang Thong,Udon Thani,13.714285714285714,10.0,13,1,12,2,0.9285714285714286,14
Ang Thong,Uthai Thani,23.916666666666668,15.416666666666666,9,3,10,2,0.75,12
Ang Thong,Uttaradit,12.636363636363637,9.818181818181818,10,1,10,1,0.9090909090909091,11
Ang Thong,Yasothon,10.833333333333334,7.722222222222222,32,4,34,2,0.8888888888888888,36
Bangkok,Bangkok,13.619047619047619,10.238095238095237,20,1,20,1,0.9523809523809523,21
Bangkok,Bueng Kan,11.5,8.720930232558139,79,7,82,4,0.9186046511627907,86
Bangkok,Buri Ram,13.07514450867052,9.323699421965317,157,16,153,20,0.9075144508670521,173
Bangkok,Chachoengsao,12.55497382198953,9.073298429319372,173,18,166,25,0.9057591623036649,191
Bangkok,Chai Nat,8.916666666666666,7.333333333333333,24,0,24,0,1.0,24
Bangkok,Chaiyaphum,10.900990099009901,7.9504950495049505,96,5,98,3,0.9504950495049505,101
Bangkok,Chanthaburi,15.478260869565217,12.0,41,5,40,6,0.8913043478260869,46
Bangkok,Chiang Mai,12.147058823529411,8.397058823529411,124,12,123,13,0.9117647058823529,136
Bangkok,Chon Buri,10.6375,7.5,73,7,73,7,0.9125,80
Bangkok,Chumphon,14.420289855072463,11.391304347826088,60,9,62,7,0.8695652173913043,69
Bangkok,Kalasin,13.416666666666666,10.036458333333334,179,13,174,18,0.9322916666666666,192
Bangkok,Kamphaeng Phet,13.925373134328359,10.611940298507463,59,8,60,7,0.8805970149253731,67
Bangkok,Kanchanaburi,12.65,9.35,18,2,19,1,0.9,20
Bangkok,Khon Kaen,12.942528735632184,9.655172413793103,82,5,79,8,0.9425287356321839,87
Bangkok,Krabi,16.085714285714285,13.0,31,4,31,4,0.8857142857142857,35
Bangkok,Lampang,11.23076923076923,8.430769230769231,55,10,60,5,0.8461538461538461,65
Bangkok,Lamphun,12.258620689655173,8.793103448275861,57,1,52,6,0.9827586206896551,58
Bangkok,Loei,7.3076923076923075,4.423076923076923,26,0,24,2,1.0,26
Bangkok,Lop Buri,13.42,10.36,46,4,47,3,0.92,50
Bangkok,Maha Sarakham,12.084158415841584,8.653465346534654,183,19,184,18,0.905940594059406,202
Bangkok,Mukdahan,11.025862068965518,7.758620689655173,110,6,102,14,0.9482758620689655,116
Bangkok,Nakhon Nayok,12.915492957746478,9.95774647887324,68,3,64,7,0.9577464788732394,71
Bangkok,Nakhon Pathom,11.909090909090908,8.654545454545454,50,5,50,5,0.9090909090909091,55
Bangkok,Nakhon Phanom,12.602209944751381,9.292817679558011,165,16,155,26,0.9116022099447514,181
Bangkok,Nakhon Ratchasima,11.895522388059701,8.414179104477611,245,23,239,29,0.914179104477612,268
Bangkok,Nakhon Sawan,11.837837837837839,8.432432432432432,35,2,32,5,0.9459459459459459,37
Bangkok,Nakhon Si Thammarat,11.642857142857142,8.952380952380953,41,1,41,1,0.9761904761904762,42
Bangkok,Narathiwat,10.153846153846153,7.3076923076923075,13,0,13,0,1.0,13
Bangkok,Nong Khai,12.166666666666666,8.416666666666666,11,1,11,1,0.9166666666666666,12
Bangkok,Nonthaburi,11.03125,8.0,29,3,30,2,0.90625,32
Bangkok,Pathum Thani,13.277777777777779,9.88888888888889,14,4,17,1,0.7777777777777778,18
Bangkok,Pattani,11.365384615384615,7.125,97,7,92,12,0.9326923076923077,104
Bangkok,Phangnga,11.6,7.8,5,0,5,0,1.0,5
Bangkok,Phatthalung,15.3125,11.4375,14,2,13,3,0.875,16
Bangkok,Phetchaburi,10.758620689655173,8.03448275862069,24,5,27,2,0.8275862068965517,29
Bangkok,Phra Nakhon Si Ayutthaya,10.258064516129032,7.064516129032258,31,0,29,2,1.0,31
Bangkok,Phrae,13.212765957446809,9.76595744680851,43,4,44,3,0.9148936170212766,47
Bangkok,Phuket,17.7,15.3,7,3,10,0,0.7,10
Bangkok,Prachin Buri,11.240384615384615,8.163461538461538,100,4,93,11,0.9615384615384616,104
Bangkok,Prachuap Khiri Khan,14.588235294117647,10.450980392156863,45,6,43,8,0.8823529411764706,51
Bangkok,Ranong,13.863636363636363,9.954545454545455,18,4,20,2,0.8181818181818182,22
Bangkok,Ratchaburi,10.577777777777778,7.733333333333333,43,2,41,4,0.9555555555555556,45
Bangkok,Rayong,10.14,6.78,49,1,43,7,0.98,50
Bangkok,Roi Et,12.012820512820513,8.66025641025641,286,26,281,31,0.9166666666666666,312
Bangkok,Sa Kaeo,11.948051948051948,9.155844155844155,75,2,75,2,0.974025974025974,77
Bangkok,Sakon Nakhon,11.712962962962964,8.777777777777779,197,19,200,16,0.9120370370370371,216
Bangkok,Samut Prakan,10.564102564102564,7.589743589743589,35,4,37,2,0.8974358974358975,39
Bangkok,Samut Sakhon,7.461538461538462,5.3076923076923075,12,1,12,1,0.9230769230769231,13
Bangkok,Samut Songkhram,13.317073170731707,9.195121951219512,30,11,35,6,0.7317073170731707,41
Bangkok,Saraburi,13.0,9.875,29,3,28,4,0.90625,32
Bangkok,Satun,16.454545454545453,12.272727272727273,9,2,11,0,0.8181818181818182,11
Bangkok,Si Sa Ket,11.903225806451612,8.258064516129032,257,22,248,31,0.921146953405018,279
Bangkok,Sing Buri,16.0,12.4,9,1,10,0,0.9,10
Bangkok,Songkhla,11.18918918918919,8.216216216216216,36,1,33,4,0.972972972972973,37
Bangkok,Sukhothai,10.714285714285714,7.928571428571429,13,1,14,0,0.9285714285714286,14
Bangkok,Suphan Buri,15.0,11.666666666666666,16,2,13,5,0.8888888888888888,18
Bangkok,Surat Thani,11.916666666666666,7.666666666666667,12,0,8,4,1.0,12
Bangkok,Surin,11.457446808510639,8.351063829787234,168,20,169,19,0.8936170212765957,188
Bangkok,Tak,10.2,7.633333333333334,29,1,28,2,0.9666666666666667,30
Bangkok,Trang,11.6,8.8,9,1,9,1,0.9,10
Bangkok,Trat,11.18,8.2,47,3,41,9,0.94,50
Bangkok,Ubon Ratchathani,11.806930693069306,8.435643564356436,184,18,182,20,0.9108910891089109,202
Bangkok,Udon Thani,13.030303030303031,8.606060606060606,29,4,27,6,0.8787878787878788,33
Bangkok,Uthai Thani,12.846153846153847,9.692307692307692,36,3,34,5,0.9230769230769231,39
Bangkok,Uttaradit,19.615384615384617,16.487179487179485,33,6,33,6,0.8461538461538461,39
Bangkok,Yala,5.5,2.0,2,0,2,0,1.0,2
Bangkok,Yasothon,10.860759493670885,7.962025316455696,74,5,73,6,0.9367088607594937,79
Bueng Kan,Bueng Kan,9.766666666666667,7.3,29,1,28,2,0.9666666666666667,30
Bueng Kan,Buri Ram,12.494623655913978,8.010752688172044,88,5,77,16,0.946236559139785,93
Bueng Kan,Chachoengsao,11.71311475409836,8.868852459016393,116,6,115,7,0.9508196721311475,122
Bueng Kan,Chai Nat,9.66,7.9,45,5,49,1,0.9,50
Bueng Kan,Chaiyaphum,9.017241379310345,6.603448275862069,56,2,56,2,0.9655172413793104,58
Bueng Kan,Chanthaburi,12.413793103448276,9.551724137931034,56,2,54,4,0.9655172413793104,58
Bueng Kan,Chiang Mai,14.07563025210084,8.378151260504202,114,5,98,21,0.957983193277311,119
Bueng Kan,Chon Buri,11.938775510204081,8.857142857142858,44,5,44,5,0.8979591836734694,49
Bueng Kan,Chumphon,15.933333333333334,12.466666666666667,12,3,13,2,0.8,15
Bueng Kan,Kalasin,13.089285714285714,8.883928571428571,98,14,98,14,0.875,112
Bueng Kan,Kamphaeng Phet,13.347826086956522,9.869565217391305,20,3,21,2,0.8695652173913043,23
Bueng Kan,Kanchanaburi,10.0,8.0,2,0,2,0,1.0,2
Bueng Kan,Khon Kaen,9.424657534246576,6.328767123287672,69,4,66,7,0.9452054794520548,73
Bueng Kan,Krabi,12.307692307692308,9.384615384615385,13,0,12,1,1.0,13
Bueng Kan,Lampang,9.934782608695652,6.1521739130434785,45,1,44,2,0.9782608695652174,46
Bueng Kan,Lamphun,16.818181818181817,11.0,17,5,18,4,0.7727272727272727,22
Bueng Kan,Loei,14.566666666666666,11.333333333333334,25,5,23,7,0.8333333333333334,30
Bueng Kan,Lop Buri,10.309859154929578,7.591549295774648,67,4,63,8,0.9436619718309859,71
Bueng Kan,Maha Sarakham,10.75206611570248,7.909090909090909,109,12,109,12,0.9008264462809917,121
Bueng Kan,Mukdahan,11.4375,8.791666666666666,45,3,43,5,0.9375,48
Bueng Kan,Nakhon Nayok,12.74,9.92,46,4,43,7,0.92,50
Bueng Kan,Nakhon Pathom,14.045454545454545,11.181818181818182,18,4,20,2,0.8181818181818182,22
Bueng Kan,Nakhon Phanom,13.247619047619047,10.219047619047618,94,11,96,9,0.8952380952380953,105
Bueng Kan,Nakhon Ratchasima,11.241610738255034,8.248322147651006,140,9,137,12,0.9395973154362416,149
Bueng Kan,Nakhon Sawan,13.222222222222221,9.5,17,1,16,2,0.9444444444444444,18
Bueng Kan,Nakhon Si Thammarat,11.764705882352942,8.411764705882353,16,1,14,3,0.9411764705882353,17
Bueng Kan,Narathiwat,7.0,5.5,2,0,2,0,1.0,2
Bueng Kan,Nong Khai,10.695652173913043,8.347826086956522,22,1,22,1,0.9565217391304348,23
Bueng Kan,Nonthaburi,12.04,8.32,24,1,25,0,0.96,25
Bueng Kan,Pathum Thani,14.741935483870968,10.258064516129032,26,5,25,6,0.8387096774193549,31
Bueng Kan,Pattani,12.347826086956522,7.6521739130434785,20,3,17,6,0.8695652173913043,23
Bueng Kan,Phangnga,13.375,9.875,8,0,8,0,1.0,8
Bueng Kan,Phatthalung,18.666666666666668,14.666666666666666,8,1,9,0,0.8888888888888888,9
Bueng Kan,Phetchaburi,9.555555555555555,7.222222222222222,9,0,9,0,1.0,9
Bueng Kan,Phra Nakhon Si Ayutthaya,10.96078431372549,7.686274509803922,49,2,50,1,0.9607843137254902,51
Bueng Kan,Phrae,11.545454545454545,10.272727272727273,11,0,11,0,1.0,11
Bueng Kan,Phuket,14.4,12.6,3,2,5,0,0.6,5
Bueng Kan,Prachin Buri,12.6375,9.8125,76,4,73,7,0.95,80
Bueng Kan,Prachuap Khiri Khan,10.928571428571429,8.071428571428571,12,2,12,2,0.8571428571428571,14
Bueng Kan,Ranong,7.142857142857143,5.142857142857143,7,0,6,1,1.0,7
Bueng Kan,Ratchaburi,7.285714285714286,4.857142857142857,20,1,19,2,0.9523809523809523,21
Bueng Kan,Rayong,10.450980392156863,7.529411764705882,49,2,46,5,0.9607843137254902,51
Bueng Kan,Roi Et,11.973154362416107,8.167785234899329,136,13,136,13,0.912751677852349,149
Bueng Kan,Sa Kaeo,11.037037037037036,7.888888888888889,24,3,23,4,0.8888888888888888,27
Bueng Kan,Sakon Nakhon,11.069767441860465,8.015503875968992,120,9,115,14,0.9302325581395349,129
Bueng Kan,Samut Prakan,10.933333333333334,6.977777777777778,41,4,36,9,0.9111111111111111,45
Bueng Kan,Samut Sakhon,8.222222222222221,5.222222222222222,9,0,8,1,1.0,9
Bueng Kan,Samut Songkhram,12.869565217391305,7.260869565217392,20,3,18,5,0.8695652173913043,23
Bueng Kan,Saraburi,12.295454545454545,9.159090909090908,79,9,81,7,0.8977272727272727,88
Bueng Kan,Satun,8.833333333333334,7.0,5,1,6,0,0.8333333333333334,6
Bueng Kan,Si Sa Ket,11.73936170212766,8.670212765957446,350,26,339,37,0.9308510638297872,376
Bueng Kan,Sing Buri,11.391304347826088,9.173913043478262,21,2,21,2,0.9130434782608695,23
Bueng Kan,Songkhla,12.933333333333334,9.333333333333334,13,2,14,1,0.8666666666666667,15
Bueng Kan,Sukhothai,25.5,16.75,3,1,2,2,0.75,4
Bueng Kan,Suphan Buri,14.5,10.416666666666666,10,2,9,3,0.8333333333333334,12
Bueng Kan,Surat Thani,11.25,7.25,6,2,6,2,0.75,8
Bueng Kan,Surin,11.49090909090909,8.666666666666666,156,9,155,10,0.9454545454545454,165
Bueng Kan,Tak,10.0,5.857142857142857,12,2,11,3,0.8571428571428571,14
Bueng Kan,Trang,13.75,12.0,3,1,4,0,0.75,4
Bueng Kan,Trat,13.35,9.425,37,3,34,6,0.925,40
Bueng Kan,Ubon Ratchathani,11.218579234972678,8.557377049180328,169,14,169,14,0.9234972677595629,183
Bueng Kan,Udon Thani,10.297872340425531,6.382978723404255,43,4,41,6,0.9148936170212766,47
Bueng Kan,Uthai Thani,11.6,8.4,10,0,9,1,1.0,10
Bueng Kan,Uttaradit,13.411764705882353,9.0,16,1,12,5,0.9411764705882353,17
Bueng Kan,Yasothon,11.727272727272727,8.287878787878787,59,7,54,12,0.8939393939393939,66
Buri Ram,Buri Ram,12.465753424657533,9.301369863013699,66,7,65,8,0.9041095890410958,73
Buri Ram,Chachoengsao,12.669642857142858,9.571428571428571,208,16,210,14,0.9285714285714286,224
Buri Ram,Chai Nat,8.58252427184466,6.446601941747573,101,2,98,5,0.9805825242718447,103
Buri Ram,Chaiyaphum,10.0,6.752577319587629,94,3,85,12,0.9690721649484536,97
Buri Ram,Chanthaburi,12.46788990825688,8.917431192660551,96,13,97,12,0.8807339449541285,109
Buri Ram,Chiang Mai,13.431472081218274,7.883248730964467,190,7,162,35,0.9644670050761421,197
Buri Ram,Chon Buri,11.569767441860465,8.151162790697674,82,4,79,7,0.9534883720930233,86
Buri Ram,Chumphon,12.709677419354838,9.548387096774194,29,2,27,4,0.9354838709677419,31
Buri Ram,Kalasin,11.123076923076923,7.8,180,15,180,15,0.9230769230769231,195
Buri Ram,Kamphaeng Phet,13.428571428571429,8.428571428571429,33,2,25,10,0.9428571428571428,35
Buri Ram,Kanchanaburi,11.9,8.5,10,0,7,3,1.0,10
Buri Ram,Khon Kaen,10.529411764705882,7.34453781512605,111,8,106,13,0.9327731092436975,119
Buri Ram,Krabi,14.566666666666666,9.9,25,5,25,5,0.8333333333333334,30
Buri Ram,Lampang,11.178082191780822,7.3561643835616435,67,6,62,11,0.9178082191780822,73
Buri Ram,Lamphun,11.159090909090908,7.136363636363637,39,5,37,7,0.8863636363636364,44
Buri Ram,Loei,12.887323943661972,9.535211267605634,63,8,64,7,0.8873239436619719,71
Buri Ram,Lop Buri,10.406015037593985,7.7368421052631575,123,10,125,8,0.924812030075188,133
Buri Ram,Maha Sarakham,11.599137931034482,8.616379310344827,210,22,203,29,0.9051724137931034,232
Buri Ram,Mukdahan,11.3125,8.275,75,5,70,10,0.9375,80
Buri Ram,Nakhon Nayok,10.383333333333333,6.833333333333333,56,4,53,7,0.9333333333333333,60
Buri Ram,Nakhon Pathom,11.192307692307692,7.230769230769231,26,0,20,6,1.0,26
Buri Ram,Nakhon Phanom,10.248704663212436,6.849740932642487,177,16,167,26,0.917098445595855,193
Buri Ram,Nakhon Ratchasima,12.152610441767068,8.738955823293173,225,24,215,34,0.9036144578313253,249
Buri Ram,Nakhon Sawan,13.894736842105264,11.578947368421053,17,2,17,2,0.8947368421052632,19
Buri Ram,Nakhon Si Thammarat,12.85,9.2,19,1,18,2,0.95,20
Buri Ram,Narathiwat,10.764705882352942,8.294117647058824,16,1,16,1,0.9411764705882353,17
Buri Ram,Nong Khai,11.891304347826088,8.847826086956522,41,5,44,2,0.8913043478260869,46
Buri Ram,Nonthaburi,11.428571428571429,7.0476190476190474,39,3,33,9,0.9285714285714286,42
Buri Ram,Pathum Thani,11.859649122807017,8.666666666666666,52,5,52,5,0.9122807017543859,57
Buri Ram,Pattani,9.9375,6.875,31,1,30,2,0.96875,32
Buri Ram,Phangnga,11.25,7.5,7,1,7,1,0.875,8
Buri Ram,Phatthalung,8.333333333333334,4.888888888888889,9,0,9,0,1.0,9
Buri Ram,Phetchaburi,13.615384615384615,10.692307692307692,12,1,12,1,0.9230769230769231,13
Buri Ram,Phra Nakhon Si Ayutthaya,12.177777777777777,8.5,82,8,80,10,0.9111111111111111,90
Buri Ram,Phrae,14.294117647058824,11.411764705882353,14,3,17,0,0.8235294117647058,17
Buri Ram,Phuket,13.0,8.666666666666666,2,1,2,1,0.6666666666666666,3
Buri Ram,Prachin Buri,13.065359477124183,9.764705882352942,138,15,132,21,0.9019607843137255,153
Buri Ram,Prachuap Khiri Khan,11.10344827586207,7.413793103448276,28,1,23,6,0.9655172413793104,29
Buri Ram,Ranong,15.25,11.0,8,0,8,0,1.0,8
Buri Ram,Ratchaburi,10.681818181818182,8.136363636363637,19,3,20,2,0.8636363636363636,22
Buri Ram,Rayong,10.906976744186046,7.906976744186046,81,5,79,7,0.9418604651162791,86
Buri Ram,Roi Et,10.597523219814242,7.405572755417957,312,11,285,38,0.9659442724458205,323
Buri Ram,Sa Kaeo,12.692307692307692,8.865384615384615,51,1,47,5,0.9807692307692307,52
Buri Ram,Sakon Nakhon,11.674897119341564,8.246913580246913,218,25,209,34,0.897119341563786,243
Buri Ram,Samut Prakan,9.095238095238095,5.571428571428571,78,6,77,7,0.9285714285714286,84
Buri Ram,Samut Sakhon,6.666666666666667,5.5,6,0,6,0,1.0,6
Buri Ram,Samut Songkhram,11.952380952380953,8.761904761904763,21,0,18,3,1.0,21
Buri Ram,Saraburi,11.1875,8.29375,151,9,153,7,0.94375,160
Buri Ram,Satun,12.8,11.4,10,0,10,0,1.0,10
Buri Ram,Si Sa Ket,12.224489795918368,9.076190476190476,664,71,654,81,0.9034013605442177,735
Buri Ram,Sing Buri,15.25531914893617,11.787234042553191,42,5,44,3,0.8936170212765957,47
Buri Ram,Songkhla,9.071428571428571,4.142857142857143,14,0,11,3,1.0,14
Buri Ram,Sukhothai,11.333333333333334,7.5,6,0,6,0,1.0,6
Buri Ram,Suphan Buri,14.636363636363637,12.454545454545455,9,2,9,2,0.8181818181818182,11
Buri Ram,Surat Thani,11.2,9.0,5,0,5,0,1.0,5
Buri Ram,Surin,11.767857142857142,8.181547619047619,302,34,290,46,0.8988095238095238,336
Buri Ram,Tak,12.875,10.25,14,2,14,2,0.875,16
Buri Ram,Trang,11.166666666666666,7.833333333333333,10,2,12,0,0.8333333333333334,12
Buri Ram,Trat,9.954128440366972,7.018348623853211,102,7,98,11,0.9357798165137615,109
Buri Ram,Ubon Ratchathani,11.282229965156795,8.062717770034844,273,14,259,28,0.9512195121951219,287
Buri Ram,Udon Thani,12.029411764705882,8.872549019607844,97,5,96,6,0.9509803921568627,102
Buri Ram,Uthai Thani,12.76923076923077,9.615384615384615,12,1,12,1,0.9230769230769231,13
Buri Ram,Uttaradit,10.866666666666667,7.266666666666667,15,0,12,3,1.0,15
Buri Ram,Yala,7.333333333333333,4.333333333333333,3,0,3,0,1.0,3
Buri Ram,Yasothon,11.33,8.22,92,8,95,5,0.92,100
Chachoengsao,Chachoengsao,12.60625,8.68125,148,12,134,26,0.925,160
Chachoengsao,Chai Nat,9.630434782608695,7.217391304347826,87,5,85,7,0.9456521739130435,92
Chachoengsao,Chaiyaphum,11.288732394366198,7.485915492957746,136,6,118,24,0.9577464788732394,142
Chachoengsao,Chanthaburi,13.024,9.776,112,13,118,7,0.896,125
Chachoengsao,Chiang Mai,14.377510040160642,9.373493975903614,227,22,219,30,0.9116465863453815,249
Chachoengsao,Chon Buri,10.952830188679245,7.8584905660377355,103,3,99,7,0.9716981132075472,106
Chachoengsao,Chumphon,11.37704918032787,8.78688524590164,58,3,57,4,0.9508196721311475,61
Chachoengsao,Kalasin,13.24025974025974,9.746753246753247,287,21,274,34,0.9318181818181818,308
Chachoengsao,Kamphaeng Phet,13.742857142857142,8.771428571428572,33,2,26,9,0.9428571428571428,35
Chachoengsao,Kanchanaburi,17.9375,13.8125,14,2,14,2,0.875,16
Chachoengsao,Khon Kaen,12.404411764705882,9.330882352941176,127,9,126,10,0.9338235294117647,136
Chachoengsao,Krabi,16.55,11.3,18,2,17,3,0.9,20
Chachoengsao,Lampang,10.543478260869565,7.293478260869565,84,8,85,7,0.9130434782608695,92
Chachoengsao,Lamphun,13.416666666666666,9.9,57,3,57,3,0.95,60
Chachoengsao,Loei,13.083333333333334,10.366666666666667,58,2,56,4,0.9666666666666667,60
Chachoengsao,Lop Buri,12.390070921985815,8.851063829787234,133,8,127,14,0.9432624113475178,141
Chachoengsao,Maha Sarakham,13.211320754716981,9.622641509433961,240,25,240,25,0.9056603773584906,265
Chachoengsao,Mukdahan,13.026315789473685,9.412280701754385,107,7,99,15,0.9385964912280702,114
Chachoengsao,Nakhon Nayok,14.36734693877551,11.061224489795919,89,9,86,12,0.9081632653061225,98
Chachoengsao,Nakhon Pathom,9.514285714285714,6.885714285714286,35,0,34,1,1.0,35
Chachoengsao,Nakhon Phanom,13.152985074626866,9.686567164179104,242,26,247,21,0.9029850746268657,268
Chachoengsao,Nakhon Ratchasima,12.950437317784257,9.457725947521865,311,32,312,31,0.9067055393586005,343
Chachoengsao,Nakhon Sawan,12.170731707317072,9.268292682926829,38,3,37,4,0.926829268292683,41
Chachoengsao,Nakhon Si Thammarat,13.542857142857143,9.257142857142858,34,1,29,6,0.9714285714285714,35
Chachoengsao,Narathiwat,11.066666666666666,7.8,14,1,15,0,0.9333333333333333,15
Chachoengsao,Nong Khai,13.13888888888889,10.027777777777779,31,5,35,1,0.8611111111111112,36
Chachoengsao,Nonthaburi,12.46808510638298,8.382978723404255,43,4,41,6,0.9148936170212766,47
Chachoengsao,Pathum Thani,11.170731707317072,7.695121951219512,76,6,75,7,0.926829268292683,82
Chachoengsao,Pattani,12.551724137931034,9.022988505747126,80,7,81,6,0.9195402298850575,87
Chachoengsao,Phangnga,13.571428571428571,10.571428571428571,6,1,7,0,0.8571428571428571,7
Chachoengsao,Phatthalung,11.88888888888889,8.666666666666666,9,0,8,1,1.0,9
Chachoengsao,Phetchaburi,12.473684210526315,8.68421052631579,17,2,16,3,0.8947368421052632,19
Chachoengsao,Phra Nakhon Si Ayutthaya,12.147727272727273,8.284090909090908,82,6,76,12,0.9318181818181818,88
Chachoengsao,Phrae,12.67741935483871,9.290322580645162,29,2,30,1,0.9354838709677419,31
Chachoengsao,Phuket,10.5,7.875,8,0,8,0,1.0,8
Chachoengsao,Prachin Buri,13.536170212765958,9.731914893617022,209,26,209,26,0.8893617021276595,235
Chachoengsao,Prachuap Khiri Khan,12.176470588235293,8.764705882352942,33,1,28,6,0.9705882352941176,34
Chachoengsao,Ranong,12.476190476190476,8.952380952380953,18,3,19,2,0.8571428571428571,21
Chachoengsao,Ratchaburi,14.131578947368421,10.5,36,2,33,5,0.9473684210526315,38
Chachoengsao,Rayong,11.289156626506024,8.421686746987952,77,6,79,4,0.927710843373494,83
Chachoengsao,Roi Et,12.306976744186047,8.80232558139535,384,46,396,34,0.8930232558139535,430
Chachoengsao,Sa Kaeo,13.51,10.13,92,8,89,11,0.92,100
Chachoengsao,Sakon Nakhon,12.71111111111111,9.275,334,26,323,37,0.9277777777777778,360
Chachoengsao,Samut Prakan,10.603174603174603,7.492063492063492,62,1,59,4,0.9841269841269841,63
Chachoengsao,Samut Sakhon,10.76923076923077,7.1923076923076925,25,1,25,1,0.9615384615384616,26
Chachoengsao,Samut Songkhram,10.857142857142858,7.738095238095238,39,3,37,5,0.9285714285714286,42
Chachoengsao,Saraburi,11.54601226993865,8.883435582822086,152,11,157,6,0.9325153374233128,163
Chachoengsao,Satun,12.733333333333333,9.4,15,0,15,0,1.0,15
Chachoengsao,Si Sa Ket,12.683574879227054,9.431159420289855,745,83,741,87,0.8997584541062802,828
Chachoengsao,Sing Buri,12.509803921568627,9.882352941176471,47,4,51,0,0.9215686274509803,51
Chachoengsao,Songkhla,10.625,7.9375,16,0,15,1,1.0,16
Chachoengsao,Sukhothai,10.88888888888889,8.222222222222221,9,0,9,0,1.0,9
Chachoengsao,Suphan Buri,27.555555555555557,23.666666666666668,4,5,9,0,0.4444444444444444,9
Chachoengsao,Surat Thani,17.09090909090909,13.909090909090908,10,1,11,0,0.9090909090909091,11
Chachoengsao,Surin,12.569920844327177,9.216358839050132,348,31,360,19,0.9182058047493403,379
Chachoengsao,Tak,14.11111111111111,10.666666666666666,17,1,16,2,0.9444444444444444,18
Chachoengsao,Trang,11.636363636363637,9.454545454545455,9,2,11,0,0.8181818181818182,11
Chachoengsao,Trat,13.573770491803279,10.040983606557377,111,11,105,17,0.9098360655737705,122
Chachoengsao,Ubon Ratchathani,11.722527472527473,8.62087912087912,338,26,340,24,0.9285714285714286,364
Chachoengsao,Udon Thani,12.793388429752065,8.380165289256198,118,3,104,17,0.9752066115702479,121
Chachoengsao,Uthai Thani,16.4390243902439,12.536585365853659,38,3,36,5,0.926829268292683,41
Chachoengsao,Uttaradit,18.5,15.5,24,6,28,2,0.8,30
Chachoengsao,Yala,18.0,14.333333333333334,3,0,2,1,1.0,3
Chachoengsao,Yasothon,11.82638888888889,8.76388888888889,135,9,134,10,0.9375,144
Chai Nat,Chai Nat,8.0,4.666666666666667,3,0,3,0,1.0,3
Chai Nat,Chaiyaphum,9.448717948717949,7.256410256410256,74,4,75,3,0.9487179487179487,78
Chai Nat,Chanthaburi,10.205882352941176,8.294117647058824,34,0,34,0,1.0,34
Chai Nat,Chiang Mai,9.80232558139535,7.593023255813954,79,7,82,4,0.9186046511627907,86
Chai Nat,Chon Buri,10.552631578947368,8.394736842105264,34,4,36,2,0.8947368421052632,38
Chai Nat,Chumphon,10.666666666666666,8.520833333333334,46,2,48,0,0.9583333333333334,48
Chai Nat,Kalasin,10.628787878787879,8.280303030303031,117,15,129,3,0.8863636363636364,132
Chai Nat,Kamphaeng Phet,9.535714285714286,7.821428571428571,27,1,28,0,0.9642857142857143,28
Chai Nat,Kanchanaburi,13.285714285714286,10.571428571428571,5,2,7,0,0.7142857142857143,7
Chai Nat,Khon Kaen,10.5,7.113636363636363,41,3,39,5,0.9318181818181818,44
Chai Nat,Krabi,17.933333333333334,15.8,13,2,15,0,0.8666666666666667,15
Chai Nat,Lampang,10.461538461538462,8.538461538461538,34,5,38,1,0.8717948717948718,39
Chai Nat,Lamphun,10.066666666666666,7.633333333333334,30,0,28,2,1.0,30
Chai Nat,Loei,10.3125,6.1875,15,1,12,4,0.9375,16
Chai Nat,Lop Buri,9.714285714285714,7.857142857142857,34,1,35,0,0.9714285714285714,35
Chai Nat,Maha Sarakham,7.444444444444445,5.401709401709402,114,3,110,7,0.9743589743589743,117
Chai Nat,Mukdahan,9.87719298245614,8.403508771929825,50,7,56,1,0.8771929824561403,57
Chai Nat,Nakhon Nayok,10.976744186046512,9.069767441860465,38,5,43,0,0.8837209302325582,43
Chai Nat,Nakhon Pathom,7.529411764705882,5.823529411764706,32,2,34,0,0.9411764705882353,34
Chai Nat,Nakhon Phanom,11.053191489361701,8.893617021276595,87,7,92,2,0.925531914893617,94
Chai Nat,Nakhon Ratchasima,10.245161290322581,8.09032258064516,142,13,148,7,0.9161290322580645,155
Chai Nat,Nakhon Sawan,8.61111111111111,7.0,17,1,18,0,0.9444444444444444,18
Chai Nat,Nakhon Si Thammarat,9.578947368421053,7.157894736842105,18,1,18,1,0.9473684210526315,19
Chai Nat,Narathiwat,7.75,6.333333333333333,12,0,12,0,1.0,12
Chai Nat,Nong Khai,8.6,7.2,4,1,5,0,0.8,5
Chai Nat,Nonthaburi,6.125,3.625,16,0,16,0,1.0,16
Chai Nat,Pathum Thani,15.625,13.5,5,3,7,1,0.625,8
Chai Nat,Pattani,10.142857142857142,6.959183673469388,46,3,41,8,0.9387755102040817,49
Chai Nat,Phangnga,7.714285714285714,5.714285714285714,7,0,7,0,1.0,7
Chai Nat,Phatthalung,9.222222222222221,8.333333333333334,8,1,9,0,0.8888888888888888,9
Chai Nat,Phetchaburi,9.647058823529411,8.176470588235293,17,0,17,0,1.0,17
Chai Nat,Phra Nakhon Si Ayutthaya,8.142857142857142,5.714285714285714,7,0,7,0,1.0,7
Chai Nat,Phrae,5.8125,4.6875,16,0,16,0,1.0,16
Chai Nat,Phuket,6.6,4.6,5,0,5,0,1.0,5
Chai Nat,Prachin Buri,8.9438202247191,6.977528089887641,82,7,88,1,0.9213483146067416,89
Chai Nat,Prachuap Khiri Khan,6.483870967741935,4.935483870967742,31,0,31,0,1.0,31
Chai Nat,Ranong,8.357142857142858,6.928571428571429,14,0,14,0,1.0,14
Chai Nat,Ratchaburi,6.958333333333333,5.333333333333333,23,1,24,0,0.9583333333333334,24
Chai Nat,Rayong,12.08,10.04,24,1,25,0,0.96,25
Chai Nat,Roi Et,9.337142857142856,7.0285714285714285,164,11,167,8,0.9371428571428572,175
Chai Nat,Sa Kaeo,11.694915254237289,9.23728813559322,54,5,55,4,0.9152542372881356,59
Chai Nat,Sakon Nakhon,10.381294964028777,8.194244604316546,125,14,133,6,0.8992805755395683,139
Chai Nat,Samut Prakan,6.882352941176471,5.235294117647059,17,0,17,0,1.0,17
Chai Nat,Samut Sakhon,10.4,7.4,9,1,9,1,0.9,10
Chai Nat,Samut Songkhram,8.64,7.04,24,1,25,0,0.96,25
Chai Nat,Saraburi,12.333333333333334,8.375,22,2,22,2,0.9166666666666666,24
Chai Nat,Satun,4.857142857142857,2.857142857142857,6,1,7,0,0.8571428571428571,7
Chai Nat,Si Sa Ket,11.371428571428572,9.278571428571428,125,15,131,9,0.8928571428571429,140
Chai Nat,Sing Buri,10.222222222222221,7.0,7,2,7,2,0.7777777777777778,9
Chai Nat,Songkhla,6.461538461538462,5.0,13,0,13,0,1.0,13
Chai Nat,Sukhothai,9.0,7.5,12,0,12,0,1.0,12
Chai Nat,Suphan Buri,11.0,9.083333333333334,11,1,11,1,0.9166666666666666,12
Chai Nat,Surat Thani,9.857142857142858,8.285714285714286,13,1,14,0,0.9285714285714286,14
Chai Nat,Surin,7.613636363636363,5.806818181818182,85,3,86,2,0.9659090909090909,88
Chai Nat,Tak,13.785714285714286,12.214285714285714,14,0,13,1,1.0,14
Chai Nat,Trang,7.5,6.75,8,0,8,0,1.0,8
Chai Nat,Trat,14.266666666666667,11.966666666666667,23,7,29,1,0.7666666666666667,30
Chai Nat,Ubon Ratchathani,9.47008547008547,7.564102564102564,113,4,115,2,0.9658119658119658,117
Chai Nat,Udon Thani,9.5,7.666666666666667,5,1,6,0,0.8333333333333334,6
Chai Nat,Uthai Thani,10.0,8.344827586206897,28,1,28,1,0.9655172413793104,29
Chai Nat,Uttaradit,11.2,9.16,22,3,25,0,0.88,25
Chai Nat,Yala,8.5,7.0,2,0,2,0,1.0,2
Chai Nat,Yasothon,8.5625,6.958333333333333,47,1,47,1,0.9791666666666666,48
Chaiyaphum,Chaiyaphum,9.868421052631579,6.631578947368421,36,2,32,6,0.9473684210526315,38
Chaiyaphum,Chanthaburi,12.25,9.525,73,7,76,4,0.9125,80
Chaiyaphum,Chiang Mai,17.50381679389313,10.67175572519084,113,18,95,36,0.8625954198473282,131
Chaiyaphum,Chon Buri,11.920634920634921,8.047619047619047,55,8,56,7,0.873015873015873,63
Chaiyaphum,Chumphon,10.285714285714286,7.5,12,2,13,1,0.8571428571428571,14
Chaiyaphum,Kalasin,11.6640625,8.3359375,113,15,119,9,0.8828125,128
Chaiyaphum,Kamphaeng Phet,15.5,10.285714285714286,9,5,10,4,0.6428571428571429,14
Chaiyaphum,Kanchanaburi,9.25,7.0,4,0,4,0,1.0,4
Chaiyaphum,Khon Kaen,12.584905660377359,8.754716981132075,48,5,47,6,0.9056603773584906,53
Chaiyaphum,Krabi,11.222222222222221,6.888888888888889,9,0,8,1,1.0,9
Chaiyaphum,Lampang,9.95,6.733333333333333,55,5,51,9,0.9166666666666666,60
Chaiyaphum,Lamphun,8.931034482758621,5.793103448275862,27,2,27,2,0.9310344827586207,29
Chaiyaphum,Loei,10.8,8.022222222222222,44,1,40,5,0.9777777777777777,45
Chaiyaphum,Lop Buri,9.845070422535212,7.380281690140845,68,3,65,6,0.9577464788732394,71
Chaiyaphum,Maha Sarakham,10.634146341463415,7.276422764227642,113,10,109,14,0.9186991869918699,123
Chaiyaphum,Mukdahan,11.666666666666666,6.743589743589744,36,3,32,7,0.9230769230769231,39
Chaiyaphum,Nakhon Nayok,11.195121951219512,8.341463414634147,38,3,37,4,0.926829268292683,41
Chaiyaphum,Nakhon Pathom,10.615384615384615,6.0,12,1,11,2,0.9230769230769231,13
Chaiyaphum,Nakhon Phanom,9.841584158415841,6.861386138613861,93,8,94,7,0.9207920792079208,101
Chaiyaphum,Nakhon Ratchasima,11.0,7.855345911949685,151,8,148,11,0.949685534591195,159
Chaiyaphum,Nakhon Sawan,10.2,8.0,5,0,5,0,1.0,5
Chaiyaphum,Nakhon Si Thammarat,8.625,6.25,8,0,8,0,1.0,8
Chaiyaphum,Narathiwat,10.0,8.2,9,1,9,1,0.9,10
Chaiyaphum,Nong Khai,9.424242424242424,7.333333333333333,33,0,33,0,1.0,33
Chaiyaphum,Nonthaburi,9.675675675675675,6.378378378378378,37,0,33,4,1.0,37
Chaiyaphum,Pathum Thani,11.5,8.633333333333333,27,3,28,2,0.9,30
Chaiyaphum,Pattani,11.307692307692308,8.192307692307692,25,1,24,2,0.9615384615384616,26
Chaiyaphum,Phangnga,11.0,9.0,2,0,2,0,1.0,2
Chaiyaphum,Phatthalung,12.0,9.545454545454545,10,1,9,2,0.9090909090909091,11
Chaiyaphum,Phetchaburi,11.571428571428571,6.714285714285714,7,0,7,0,1.0,7
Chaiyaphum,Phra Nakhon Si Ayutthaya,11.46774193548387,6.887096774193548,60,2,40,22,0.967741935483871,62
Chaiyaphum,Phrae,15.333333333333334,13.0,6,0,6,0,1.0,6
Chaiyaphum,Phuket,10.0,6.0,1,0,1,0,1.0,1
Chaiyaphum,Prachin Buri,11.70103092783505,8.989690721649485,89,8,90,7,0.9175257731958762,97
Chaiyaphum,Prachuap Khiri Khan,10.071428571428571,6.285714285714286,14,0,12,2,1.0,14
Chaiyaphum,Ranong,11.0,8.0,4,0,3,1,1.0,4
Chaiyaphum,Ratchaburi,10.375,7.0,8,0,8,0,1.0,8
Chaiyaphum,Rayong,8.266666666666667,5.777777777777778,45,0,43,2,1.0,45
Chaiyaphum,Roi Et,10.43010752688172,7.32258064516129,168,18,172,14,0.9032258064516129,186
Chaiyaphum,Sa Kaeo,11.46875,8.15625,30,2,28,4,0.9375,32
Chaiyaphum,Sakon Nakhon,9.854014598540147,7.386861313868613,125,12,128,9,0.9124087591240876,137
Chaiyaphum,Samut Prakan,9.742857142857142,6.371428571428571,35,0,29,6,1.0,35
Chaiyaphum,Samut Sakhon,9.285714285714286,4.428571428571429,7,0,5,2,1.0,7
Chaiyaphum,Samut Songkhram,14.214285714285714,11.071428571428571,12,2,13,1,0.8571428571428571,14
Chaiyaphum,Saraburi,13.053030303030303,10.386363636363637,122,10,131,1,0.9242424242424242,132
Chaiyaphum,Satun,7.2,4.2,5,0,5,0,1.0,5
Chaiyaphum,Si Sa Ket,13.009153318077804,9.292906178489703,388,49,394,43,0.8878718535469108,437
Chaiyaphum,Sing Buri,12.741935483870968,9.451612903225806,27,4,28,3,0.8709677419354839,31
Chaiyaphum,Songkhla,9.333333333333334,7.833333333333333,6,0,6,0,1.0,6
Chaiyaphum,Sukhothai,6.166666666666667,4.5,3,3,6,0,0.5,6
Chaiyaphum,Suphan Buri,8.2,6.6,5,0,5,0,1.0,5
Chaiyaphum,Surat Thani,12.8,9.6,4,1,5,0,0.8,5
Chaiyaphum,Surin,12.403940886699507,8.650246305418719,187,16,175,28,0.9211822660098522,203
Chaiyaphum,Tak,10.6,8.0,5,0,5,0,1.0,5
Chaiyaphum,Trang,6.666666666666667,3.6666666666666665,3,0,3,0,1.0,3
Chaiyaphum,Trat,15.824561403508772,12.473684210526315,46,11,48,9,0.8070175438596491,57
Chaiyaphum,Ubon Ratchathani,11.335329341317365,8.173652694610778,158,9,150,17,0.9461077844311377,167
Chaiyaphum,Udon Thani,12.164383561643836,9.164383561643836,70,3,71,2,0.958904109589041,73
Chaiyaphum,Uthai Thani,12.1,8.1,9,1,8,2,0.9,10
Chaiyaphum,Uttaradit,11.1,8.6,7,3,8,2,0.7,10
Chaiyaphum,Yala,8.75,6.5,4,0,4,0,1.0,4
Chaiyaphum,Yasothon,10.294117647058824,7.196078431372549,48,3,46,5,0.9411764705882353,51
Chanthaburi,Chanthaburi,11.48,9.24,24,1,23,2,0.96,25
Chanthaburi,Chiang Mai,13.5625,9.080357142857142,105,7,101,11,0.9375,112
Chanthaburi,Chon Buri,13.071428571428571,10.267857142857142,49,7,54,2,0.875,56
Chanthaburi,Chumphon,13.11111111111111,10.962962962962964,24,3,24,3,0.8888888888888888,27
Chanthaburi,Kalasin,12.169117647058824,9.580882352941176,124,12,125,11,0.9117647058823529,136
Chanthaburi,Kamphaeng Phet,10.407407407407407,8.037037037037036,26,1,26,1,0.9629629629629629,27
Chanthaburi,Kanchanaburi,9.666666666666666,5.888888888888889,7,2,7,2,0.7777777777777778,9
Chanthaburi,Khon Kaen,14.903846153846153,11.961538461538462,42,10,46,6,0.8076923076923077,52
Chanthaburi,Krabi,10.375,7.75,8,0,7,1,1.0,8
Chanthaburi,Lampang,11.61111111111111,8.666666666666666,34,2,31,5,0.9444444444444444,36
Chanthaburi,Lamphun,11.303030303030303,9.515151515151516,31,2,33,0,0.9393939393939394,33
Chanthaburi,Loei,11.3,8.45,19,1,18,2,0.95,20
Chanthaburi,Lop Buri,13.622641509433961,10.60377358490566,45,8,46,7,0.8490566037735849,53
Chanthaburi,Maha Sarakham,12.325581395348838,9.37984496124031,118,11,123,6,0.9147286821705426,129
Chanthaburi,Mukdahan,11.345454545454546,8.836363636363636,51,4,50,5,0.9272727272727272,55
Chanthaburi,Nakhon Nayok,12.136363636363637,9.318181818181818,41,3,41,3,0.9318181818181818,44
Chanthaburi,Nakhon Pathom,8.653846153846153,6.3076923076923075,25,1,22,4,0.9615384615384616,26
Chanthaburi,Nakhon Phanom,11.785046728971963,8.981308411214954,100,7,97,10,0.9345794392523364,107
Chanthaburi,Nakhon Ratchasima,11.96551724137931,8.718390804597702,156,18,155,19,0.896551724137931,174
Chanthaburi,Nakhon Sawan,11.681818181818182,9.272727272727273,20,2,21,1,0.9090909090909091,22
Chanthaburi,Nakhon Si Thammarat,11.4,8.533333333333333,14,1,12,3,0.9333333333333333,15
Chanthaburi,Narathiwat,10.571428571428571,7.214285714285714,13,1,11,3,0.9285714285714286,14
Chanthaburi,Nong Khai,10.944444444444445,8.833333333333334,15,3,16,2,0.8333333333333334,18
Chanthaburi,Nonthaburi,12.272727272727273,10.363636363636363,21,1,20,2,0.9545454545454546,22
Chanthaburi,Pathum Thani,12.285714285714286,9.464285714285714,26,2,26,2,0.9285714285714286,28
Chanthaburi,Pattani,10.666666666666666,8.117647058823529,48,3,48,3,0.9411764705882353,51
Chanthaburi,Phangnga,8.5,5.2,10,0,9,1,1.0,10
Chanthaburi,Phatthalung,10.5,8.0,6,0,6,0,1.0,6
Chanthaburi,Phetchaburi,18.25,15.875,6,2,8,0,0.75,8
Chanthaburi,Phra Nakhon Si Ayutthaya,10.32258064516129,7.806451612903226,30,1,29,2,0.967741935483871,31
Chanthaburi,Phrae,13.941176470588236,10.764705882352942,14,3,15,2,0.8235294117647058,17
Chanthaburi,Phuket,13.166666666666666,10.666666666666666,6,0,6,0,1.0,6
Chanthaburi,Prachin Buri,12.411764705882353,9.411764705882353,64,4,63,5,0.9411764705882353,68
Chanthaburi,Prachuap Khiri Khan,8.681818181818182,6.454545454545454,19,3,21,1,0.8636363636363636,22
Chanthaburi,Ranong,13.076923076923077,10.384615384615385,9,4,11,2,0.6923076923076923,13
Chanthaburi,Ratchaburi,14.842105263157896,9.68421052631579,16,3,16,3,0.8421052631578947,19
Chanthaburi,Rayong,12.448275862068966,10.10344827586207,28,1,26,3,0.9655172413793104,29
Chanthaburi,Roi Et,11.516908212560386,8.734299516908212,188,19,189,18,0.9082125603864735,207
Chanthaburi,Sa Kaeo,14.375,10.925,36,4,34,6,0.9,40
Chanthaburi,Sakon Nakhon,11.54225352112676,8.661971830985916,131,11,128,14,0.9225352112676056,142
Chanthaburi,Samut Prakan,9.133333333333333,7.433333333333334,28,2,29,1,0.9333333333333333,30
Chanthaburi,Samut Sakhon,10.181818181818182,6.363636363636363,10,1,9,2,0.9090909090909091,11
Chanthaburi,Samut Songkhram,14.681818181818182,11.5,19,3,21,1,0.8636363636363636,22
Chanthaburi,Saraburi,12.629032258064516,10.14516129032258,56,6,58,4,0.9032258064516129,62
Chanthaburi,Satun,14.714285714285714,11.857142857142858,6,1,7,0,0.8571428571428571,7
Chanthaburi,Si Sa Ket,13.143322475570033,10.133550488599349,280,27,275,32,0.9120521172638436,307
Chanthaburi,Sing Buri,13.694444444444445,9.833333333333334,35,1,30,6,0.9722222222222222,36
Chanthaburi,Songkhla,9.375,7.375,16,0,16,0,1.0,16
Chanthaburi,Sukhothai,17.0,14.375,6,2,8,0,0.75,8
Chanthaburi,Suphan Buri,13.0,8.875,8,0,7,1,1.0,8
Chanthaburi,Surat Thani,9.0,7.0,4,0,4,0,1.0,4
Chanthaburi,Surin,12.227586206896552,9.289655172413793,130,15,132,13,0.896551724137931,145
Chanthaburi,Tak,10.8125,8.375,13,3,13,3,0.8125,16
Chanthaburi,Trang,13.3,10.3,9,1,9,1,0.9,10
Chanthaburi,Trat,11.75609756097561,8.634146341463415,38,3,38,3,0.926829268292683,41
Chanthaburi,Ubon Ratchathani,13.882352941176471,11.058823529411764,139,14,138,15,0.9084967320261438,153
Chanthaburi,Udon Thani,13.8,10.04,46,4,44,6,0.92,50
Chanthaburi,Uthai Thani,14.774193548387096,12.67741935483871,27,4,31,0,0.8709677419354839,31
Chanthaburi,Uttaradit,11.875,9.5625,14,2,14,2,0.875,16
Chanthaburi,Yala,19.0,15.333333333333334,3,0,3,0,1.0,3
Chanthaburi,Yasothon,10.793103448275861,8.327586206896552,56,2,53,5,0.9655172413793104,58
Chiang Mai,Chiang Mai,15.245454545454546,7.345454545454546,100,10,86,24,0.9090909090909091,110
Chiang Mai,Chon Buri,12.711711711711711,7.297297297297297,106,5,97,14,0.954954954954955,111
Chiang Mai,Chumphon,16.14814814814815,8.907407407407407,51,3,48,6,0.9444444444444444,54
Chiang Mai,Kalasin,13.98936170212766,9.707446808510639,179,9,171,17,0.9521276595744681,188
Chiang Mai,Kamphaeng Phet,15.868421052631579,9.105263157894736,37,1,33,5,0.9736842105263158,38
Chiang Mai,Kanchanaburi,15.285714285714286,10.285714285714286,6,1,7,0,0.8571428571428571,7
Chiang Mai,Khon Kaen,13.208333333333334,9.483333333333333,106,14,108,12,0.8833333333333333,120
Chiang Mai,Krabi,15.25,10.357142857142858,26,2,24,4,0.9285714285714286,28
Chiang Mai,Lampang,11.842857142857143,6.5285714285714285,68,2,63,7,0.9714285714285714,70
Chiang Mai,Lamphun,18.644444444444446,10.2,43,2,34,11,0.9555555555555556,45
Chiang Mai,Loei,13.78048780487805,10.439024390243903,38,3,40,1,0.926829268292683,41
Chiang Mai,Lop Buri,13.358108108108109,9.736486486486486,138,10,135,13,0.9324324324324325,148
Chiang Mai,Maha Sarakham,15.464646464646465,9.212121212121213,181,17,156,42,0.9141414141414141,198
Chiang Mai,Mukdahan,15.431818181818182,9.079545454545455,80,8,73,15,0.9090909090909091,88
Chiang Mai,Nakhon Nayok,13.013333333333334,7.24,73,2,59,16,0.9733333333333334,75
Chiang Mai,Nakhon Pathom,12.1,8.0,20,0,18,2,1.0,20
Chiang Mai,Nakhon Phanom,14.9438202247191,9.51123595505618,166,12,156,22,0.9325842696629213,178
Chiang Mai,Nakhon Ratchasima,13.847402597402597,8.418831168831169,283,25,270,38,0.9188311688311688,308
Chiang Mai,Nakhon Sawan,13.96,8.04,24,1,23,2,0.96,25
Chiang Mai,Nakhon Si Thammarat,15.55,7.2,18,2,11,9,0.9,20
Chiang Mai,Narathiwat,15.857142857142858,9.0,13,1,9,5,0.9285714285714286,14
Chiang Mai,Nong Khai,13.133333333333333,10.8,39,6,42,3,0.8666666666666667,45
Chiang Mai,Nonthaburi,11.5,6.612903225806452,58,4,54,8,0.9354838709677419,62
Chiang Mai,Pathum Thani,13.298245614035087,8.929824561403509,52,5,51,6,0.9122807017543859,57
Chiang Mai,Pattani,17.0,10.455882352941176,59,9,57,11,0.8676470588235294,68
Chiang Mai,Phangnga,9.272727272727273,5.363636363636363,11,0,10,1,1.0,11
Chiang Mai,Phatthalung,15.076923076923077,9.461538461538462,12,1,9,4,0.9230769230769231,13
Chiang Mai,Phetchaburi,11.826086956521738,6.3478260869565215,21,2,20,3,0.9130434782608695,23
Chiang Mai,Phra Nakhon Si Ayutthaya,11.895348837209303,7.1395348837209305,74,12,72,14,0.8604651162790697,86
Chiang Mai,Phrae,16.424242424242426,8.93939393939394,30,3,27,6,0.9090909090909091,33
Chiang Mai,Phuket,17.375,6.625,7,1,4,4,0.875,8
Chiang Mai,Prachin Buri,11.751824817518248,7.788321167883212,133,4,124,13,0.9708029197080292,137
Chiang Mai,Prachuap Khiri Khan,15.321428571428571,7.0,26,2,20,8,0.9285714285714286,28
Chiang Mai,Ranong,20.916666666666668,15.333333333333334,6,6,10,2,0.5,12
Chiang Mai,Ratchaburi,14.064516129032258,7.161290322580645,30,1,26,5,0.967741935483871,31
Chiang Mai,Rayong,11.5,8.071428571428571,66,4,62,8,0.9428571428571428,70
Chiang Mai,Roi Et,14.656626506024097,8.575301204819278,303,29,277,55,0.9126506024096386,332
Chiang Mai,Sa Kaeo,15.289156626506024,9.63855421686747,76,7,76,7,0.9156626506024096,83
Chiang Mai,Sakon Nakhon,13.748091603053435,8.473282442748092,244,18,222,40,0.9312977099236641,262
Chiang Mai,Samut Prakan,16.476923076923075,10.061538461538461,57,8,50,15,0.8769230769230769,65
Chiang Mai,Samut Sakhon,11.0,5.428571428571429,13,1,10,4,0.9285714285714286,14
Chiang Mai,Samut Songkhram,14.682926829268293,6.2926829268292686,36,5,34,7,0.8780487804878049,41
Chiang Mai,Saraburi,12.13138686131387,9.02919708029197,129,8,130,7,0.9416058394160584,137
Chiang Mai,Satun,12.666666666666666,7.666666666666667,3,0,2,1,1.0,3
Chiang Mai,Si Sa Ket,12.948224852071005,9.1198224852071,626,50,608,68,0.9260355029585798,676
Chiang Mai,Sing Buri,14.75609756097561,11.195121951219512,38,3,36,5,0.926829268292683,41
Chiang Mai,Songkhla,13.619047619047619,6.809523809523809,20,1,16,5,0.9523809523809523,21
Chiang Mai,Sukhothai,12.416666666666666,7.0,12,0,12,0,1.0,12
Chiang Mai,Suphan Buri,11.125,6.25,8,0,8,0,1.0,8
Chiang Mai,Surat Thani,20.933333333333334,13.0,11,4,13,2,0.7333333333333333,15
Chiang Mai,Surin,13.250755287009063,8.50453172205438,311,20,301,30,0.9395770392749244,331
Chiang Mai,Tak,16.333333333333332,9.476190476190476,20,1,21,0,0.9523809523809523,21
Chiang Mai,Trang,10.25,4.75,8,0,6,2,1.0,8
Chiang Mai,Trat,14.36144578313253,10.36144578313253,73,10,73,10,0.8795180722891566,83
Chiang Mai,Ubon Ratchathani,14.788590604026846,9.114093959731544,277,21,257,41,0.9295302013422819,298
Chiang Mai,Udon Thani,12.788235294117648,8.411764705882353,81,4,73,12,0.9529411764705882,85
Chiang Mai,Uthai Thani,11.5,6.8076923076923075,25,1,24,2,0.9615384615384616,26
Chiang Mai,Uttaradit,13.363636363636363,7.878787878787879,31,2,29,4,0.9393939393939394,33
Chiang Mai,Yala,10.0,2.6666666666666665,3,0,3,0,1.0,3
Chiang Mai,Yasothon,13.933333333333334,9.104761904761904,99,6,97,8,0.9428571428571428,105
Chon Buri,Chon Buri,11.12,7.4,22,3,21,4,0.88,25
Chon Buri,Chumphon,13.25,8.8125,15,1,13,3,0.9375,16
Chon Buri,Kalasin,11.911764705882353,8.860294117647058,127,9,125,11,0.9338235294117647,136
Chon Buri,Kamphaeng Phet,9.285714285714286,6.714285714285714,20,1,21,0,0.9523809523809523,21
Chon Buri,Kanchanaburi,8.777777777777779,6.777777777777778,9,0,9,0,1.0,9
Chon Buri,Khon Kaen,14.671875,11.71875,56,8,60,4,0.875,64
Chon Buri,Krabi,19.375,12.125,6,2,6,2,0.75,8
Chon Buri,Lampang,13.225,8.675,38,2,33,7,0.95,40
Chon Buri,Lamphun,10.95,8.95,19,1,19,1,0.95,20
Chon Buri,Loei,14.2,10.133333333333333,29,1,24,6,0.9666666666666667,30
Chon Buri,Lop Buri,14.444444444444445,11.092592592592593,50,4,51,3,0.9259259259259259,54
Chon Buri,Maha Sarakham,14.912621359223301,10.37864077669903,89,14,81,22,0.8640776699029126,103
Chon Buri,Mukdahan,12.862068965517242,7.862068965517241,23,6,27,2,0.7931034482758621,29
Chon Buri,Nakhon Nayok,14.622222222222222,11.311111111111112,40,5,42,3,0.8888888888888888,45
Chon Buri,Nakhon Pathom,13.125,9.75,7,1,6,2,0.875,8
Chon Buri,Nakhon Phanom,9.351648351648352,6.758241758241758,87,4,88,3,0.9560439560439561,91
Chon Buri,Nakhon Ratchasima,12.814569536423841,9.099337748344372,133,18,132,19,0.8807947019867549,151
Chon Buri,Nakhon Sawan,9.571428571428571,5.714285714285714,13,1,13,1,0.9285714285714286,14
Chon Buri,Nakhon Si Thammarat,13.0,10.11111111111111,8,1,9,0,0.8888888888888888,9
Chon Buri,Narathiwat,8.5,5.333333333333333,6,0,5,1,1.0,6
Chon Buri,Nong Khai,12.375,9.666666666666666,23,1,23,1,0.9583333333333334,24
Chon Buri,Nonthaburi,15.333333333333334,10.11111111111111,16,2,16,2,0.8888888888888888,18
Chon Buri,Pathum Thani,11.32,7.36,21,4,22,3,0.84,25
Chon Buri,Pattani,15.357142857142858,10.261904761904763,31,11,36,6,0.7380952380952381,42
Chon Buri,Phangnga,11.5,3.0,3,1,2,2,0.75,4
Chon Buri,Phatthalung,13.3,9.0,8,2,7,3,0.8,10
Chon Buri,Phetchaburi,7.333333333333333,5.833333333333333,6,0,6,0,1.0,6
Chon Buri,Phra Nakhon Si Ayutthaya,10.959183673469388,7.877551020408164,47,2,44,5,0.9591836734693877,49
Chon Buri,Phrae,12.866666666666667,10.0,15,0,14,1,1.0,15
Chon Buri,Phuket,9.25,5.5,4,0,4,0,1.0,4
Chon Buri,Prachin Buri,13.119047619047619,9.833333333333334,77,7,80,4,0.9166666666666666,84
Chon Buri,Prachuap Khiri Khan,8.083333333333334,4.25,12,0,10,2,1.0,12
Chon Buri,Ranong,12.75,9.0,3,1,4,0,0.75,4
Chon Buri,Ratchaburi,17.666666666666668,11.916666666666666,9,3,10,2,0.75,12
Chon Buri,Rayong,13.342105263157896,10.289473684210526,37,1,33,5,0.9736842105263158,38
Chon Buri,Roi Et,11.169491525423728,7.423728813559322,158,19,155,22,0.8926553672316384,177
Chon Buri,Sa Kaeo,11.333333333333334,9.0,34,2,34,2,0.9444444444444444,36
Chon Buri,Sakon Nakhon,12.97841726618705,9.273381294964029,121,18,120,19,0.8705035971223022,139
Chon Buri,Samut Prakan,9.705882352941176,6.470588235294118,34,0,32,2,1.0,34
Chon Buri,Samut Sakhon,6.2,4.0,5,0,5,0,1.0,5
Chon Buri,Samut Songkhram,15.454545454545455,7.454545454545454,11,0,6,5,1.0,11
Chon Buri,Saraburi,14.0625,10.0,75,5,70,10,0.9375,80
Chon Buri,Satun,9.0,6.833333333333333,6,0,6,0,1.0,6
Chon Buri,Si Sa Ket,13.775641025641026,10.185897435897436,272,40,285,27,0.8717948717948718,312
Chon Buri,Sing Buri,11.571428571428571,8.666666666666666,21,0,20,1,1.0,21
Chon Buri,Songkhla,9.5,6.375,8,0,7,1,1.0,8
Chon Buri,Sukhothai,13.166666666666666,8.666666666666666,6,0,6,0,1.0,6
Chon Buri,Suphan Buri,14.6,10.4,5,0,3,2,1.0,5
Chon Buri,Surat Thani,13.5,10.0,2,0,2,0,1.0,2
Chon Buri,Surin,12.216867469879517,9.168674698795181,151,15,156,10,0.9096385542168675,166
Chon Buri,Tak,17.0,12.333333333333334,5,1,6,0,0.8333333333333334,6
Chon Buri,Trang,6.75,3.75,4,0,3,1,1.0,4
Chon Buri,Trat,12.02,8.1,47,3,42,8,0.94,50
Chon Buri,Ubon Ratchathani,10.773972602739725,7.945205479452055,137,9,137,9,0.9383561643835616,146
Chon Buri,Udon Thani,12.571428571428571,7.428571428571429,41,1,35,7,0.9761904761904762,42
Chon Buri,Uthai Thani,12.055555555555555,9.722222222222221,16,2,16,2,0.8888888888888888,18
Chon Buri,Uttaradit,10.291666666666666,6.75,24,0,23,1,1.0,24
Chon Buri,Yala,14.0,12.0,1,0,1,0,1.0,1
Chon Buri,Yasothon,10.641509433962264,7.528301886792453,52,1,48,5,0.9811320754716981,53
Chumphon,Kalasin,13.542857142857143,10.371428571428572,34,1,33,2,0.9714285714285714,35
Chumphon,Khon Kaen,13.857142857142858,11.047619047619047,40,2,42,0,0.9523809523809523,42
Chumphon,Lampang,14.642857142857142,11.642857142857142,13,1,12,2,0.9285714285714286,14
Chumphon,Lamphun,8.666666666666666,6.666666666666667,3,0,3,0,1.0,3
Chumphon,Loei,14.375,10.4375,32,0,26,6,1.0,32
Chumphon,Lop Buri,11.55813953488372,8.418604651162791,40,3,40,3,0.9302325581395349,43
Chumphon,Maha Sarakham,12.659574468085106,9.297872340425531,41,6,42,5,0.8723404255319149,47
Chumphon,Mukdahan,10.5,6.0,16,0,14,2,1.0,16
Chumphon,Nakhon Nayok,14.692307692307692,11.76923076923077,12,1,12,1,0.9230769230769231,13
Chumphon,Nakhon Phanom,10.606060606060606,8.272727272727273,33,0,32,1,1.0,33
Chumphon,Nakhon Ratchasima,13.8,8.709090909090909,53,2,41,14,0.9636363636363636,55
Chumphon,Nong Khai,10.333333333333334,7.611111111111111,18,0,16,2,1.0,18
Chumphon,Nonthaburi,15.153846153846153,10.923076923076923,12,1,9,4,0.9230769230769231,13
Chumphon,Pathum Thani,14.210526315789474,10.473684210526315,17,2,16,3,0.8947368421052632,19
Chumphon,Phra Nakhon Si Ayutthaya,10.818181818181818,7.136363636363637,22,0,20,2,1.0,22
Chumphon,Prachin Buri,11.477272727272727,8.5,43,1,37,7,0.9772727272727273,44
Chumphon,Rayong,15.04,11.88,21,4,24,1,0.84,25
Chumphon,Roi Et,12.7,9.15,55,5,50,10,0.9166666666666666,60
Chumphon,Sa Kaeo,11.8,9.6,5,0,5,0,1.0,5
Chumphon,Sakon Nakhon,11.21875,8.53125,31,1,30,2,0.96875,32
Chumphon,Samut Prakan,9.0,7.444444444444445,18,0,17,1,1.0,18
Chumphon,Saraburi,12.867647058823529,9.970588235294118,64,4,66,2,0.9411764705882353,68
Chumphon,Si Sa Ket,12.963963963963964,9.905405405405405,209,13,204,18,0.9414414414414415,222
Chumphon,Sing Buri,17.833333333333332,11.416666666666666,10,2,9,3,0.8333333333333334,12
Chumphon,Surin,13.94915254237288,10.889830508474576,102,16,107,11,0.864406779661017,118
Chumphon,Trat,11.206896551724139,8.03448275862069,26,3,24,5,0.896551724137931,29
Chumphon,Ubon Ratchathani,15.866666666666667,12.84,67,8,68,7,0.8933333333333333,75
Chumphon,Udon Thani,10.571428571428571,6.8,35,0,32,3,1.0,35
Chumphon,Yasothon,9.75,6.8125,16,0,15,1,1.0,16
Kalasin,Kalasin,13.656716417910447,10.373134328358208,120,14,124,10,0.8955223880597015,134
Kalasin,Kamphaeng Phet,11.232558139534884,7.767441860465116,41,2,38,5,0.9534883720930233,43
Kalasin,Kanchanaburi,11.444444444444445,10.11111111111111,9,0,9,0,1.0,9
Kalasin,Khon Kaen,14.241935483870968,10.943548387096774,109,15,115,9,0.8790322580645161,124
Kalasin,Krabi,13.458333333333334,11.291666666666666,21,3,23,1,0.875,24
Kalasin,Lampang,10.051546391752577,7.298969072164948,93,4,88,9,0.9587628865979382,97
Kalasin,Lamphun,10.86046511627907,8.255813953488373,42,1,42,1,0.9767441860465116,43
Kalasin,Loei,14.283333333333333,11.05,55,5,55,5,0.9166666666666666,60
Kalasin,Lop Buri,11.560283687943262,8.4822695035461,129,12,129,12,0.9148936170212766,141
Kalasin,Maha Sarakham,12.899253731343284,9.690298507462687,235,33,231,37,0.8768656716417911,268
Kalasin,Mukdahan,12.823529411764707,9.152941176470588,78,7,77,8,0.9176470588235294,85
Kalasin,Nakhon Nayok,11.925373134328359,9.104477611940299,64,3,63,4,0.9552238805970149,67
Kalasin,Nakhon Pathom,11.1875,8.46875,31,1,31,1,0.96875,32
Kalasin,Nakhon Phanom,11.207207207207206,8.99099099099099,208,14,206,16,0.9369369369369369,222
Kalasin,Nakhon Ratchasima,12.246913580246913,8.938271604938272,303,21,297,27,0.9351851851851852,324
Kalasin,Nakhon Sawan,10.45,7.5,39,1,37,3,0.975,40
Kalasin,Nakhon Si Thammarat,13.53125,10.53125,27,5,29,3,0.84375,32
Kalasin,Narathiwat,13.708333333333334,10.208333333333334,23,1,22,2,0.9583333333333334,24
Kalasin,Nong Khai,13.375,10.825,36,4,38,2,0.9,40
Kalasin,Nonthaburi,13.226415094339623,9.30188679245283,47,6,50,3,0.8867924528301887,53
Kalasin,Pathum Thani,14.53448275862069,11.10344827586207,54,4,48,10,0.9310344827586207,58
Kalasin,Pattani,9.704918032786885,7.39344262295082,57,4,59,2,0.9344262295081968,61
Kalasin,Phangnga,10.142857142857142,9.285714285714286,7,0,7,0,1.0,7
Kalasin,Phatthalung,9.090909090909092,5.136363636363637,21,1,20,2,0.9545454545454546,22
Kalasin,Phetchaburi,12.5,8.55,20,0,17,3,1.0,20
Kalasin,Phra Nakhon Si Ayutthaya,11.793478260869565,8.576086956521738,89,3,79,13,0.967391304347826,92
Kalasin,Phrae,11.73076923076923,8.384615384615385,23,3,24,2,0.8846153846153846,26
Kalasin,Phuket,8.75,6.416666666666667,12,0,10,2,1.0,12
Kalasin,Prachin Buri,12.782178217821782,9.698019801980198,187,15,186,16,0.9257425742574258,202
Kalasin,Prachuap Khiri Khan,10.89655172413793,7.655172413793103,27,2,24,5,0.9310344827586207,29
Kalasin,Ranong,9.5625,6.875,15,1,14,2,0.9375,16
Kalasin,Ratchaburi,12.93939393939394,9.545454545454545,29,4,29,4,0.8787878787878788,33
Kalasin,Rayong,10.9375,8.1375,77,3,74,6,0.9625,80
Kalasin,Roi Et,11.852777777777778,9.033333333333333,332,28,333,27,0.9222222222222223,360
Kalasin,Sa Kaeo,12.512820512820513,9.115384615384615,67,11,66,12,0.8589743589743589,78
Kalasin,Sakon Nakhon,12.324909747292418,9.678700361010831,249,28,262,15,0.8989169675090253,277
Kalasin,Samut Prakan,10.117647058823529,6.676470588235294,61,7,62,6,0.8970588235294118,68
Kalasin,Samut Sakhon,9.625,5.625,7,1,6,2,0.875,8
Kalasin,Samut Songkhram,12.275,9.75,36,4,38,2,0.9,40
Kalasin,Saraburi,11.556818181818182,8.778409090909092,163,13,164,12,0.9261363636363636,176
Kalasin,Satun,8.25,6.25,4,0,4,0,1.0,4
Kalasin,Si Sa Ket,12.38680465717982,9.209573091849935,713,60,712,61,0.9223803363518758,773
Kalasin,Sing Buri,15.456521739130435,12.934782608695652,39,7,42,4,0.8478260869565217,46
Kalasin,Songkhla,11.833333333333334,8.61111111111111,18,0,16,2,1.0,18
Kalasin,Sukhothai,9.428571428571429,7.285714285714286,7,0,7,0,1.0,7
Kalasin,Suphan Buri,12.818181818181818,10.272727272727273,10,1,11,0,0.9090909090909091,11
Kalasin,Surat Thani,7.7,5.0,10,0,10,0,1.0,10
Kalasin,Surin,13.164921465968586,10.034031413612565,350,32,350,32,0.9162303664921466,382
Kalasin,Tak,11.137931034482758,8.068965517241379,29,0,27,2,1.0,29
Kalasin,Trang,8.76923076923077,6.3076923076923075,13,0,12,1,1.0,13
Kalasin,Trat,14.262135922330097,10.854368932038835,95,8,92,11,0.9223300970873787,103
Kalasin,Ubon Ratchathani,12.002881844380404,9.337175792507205,326,21,328,19,0.9394812680115274,347
Kalasin,Udon Thani,12.023809523809524,8.595238095238095,121,5,117,9,0.9603174603174603,126
Kalasin,Uthai Thani,13.625,11.375,20,4,24,0,0.8333333333333334,24
Kalasin,Uttaradit,10.86111111111111,8.305555555555555,34,2,32,4,0.9444444444444444,36
Kalasin,Yala,9.666666666666666,6.0,3,0,3,0,1.0,3
Kalasin,Yasothon,11.814814814814815,9.166666666666666,101,7,101,7,0.9351851851851852,108
Kamphaeng Phet,Khon Kaen,9.727272727272727,6.2727272727272725,21,1,20,2,0.9545454545454546,22
Kamphaeng Phet,Lampang,9.916666666666666,7.583333333333333,11,1,12,0,0.9166666666666666,12
Kamphaeng Phet,Lamphun,11.0,6.4,5,0,3,2,1.0,5
Kamphaeng Phet,Loei,18.565217391304348,15.391304347826088,16,7,19,4,0.6956521739130435,23
Kamphaeng Phet,Lop Buri,12.113636363636363,9.113636363636363,40,4,42,2,0.9090909090909091,44
Kamphaeng Phet,Maha Sarakham,13.0,10.355555555555556,39,6,42,3,0.8666666666666667,45
Kamphaeng Phet,Mukdahan,12.5,9.9,9,1,8,2,0.9,10
Kamphaeng Phet,Nakhon Nayok,13.833333333333334,11.666666666666666,6,0,6,0,1.0,6
Kamphaeng Phet,Nakhon Phanom,13.81578947368421,10.921052631578947,31,7,32,6,0.8157894736842105,38
Kamphaeng Phet,Nakhon Ratchasima,12.977272727272727,9.727272727272727,39,5,39,5,0.8863636363636364,44
Kamphaeng Phet,Nong Khai,11.25,8.083333333333334,10,2,10,2,0.8333333333333334,12
Kamphaeng Phet,Nonthaburi,13.2,7.6,4,1,4,1,0.8,5
Kamphaeng Phet,Pathum Thani,13.066666666666666,9.8,14,1,12,3,0.9333333333333333,15
Kamphaeng Phet,Phra Nakhon Si Ayutthaya,11.074074074074074,8.037037037037036,26,1,27,0,0.9629629629629629,27
Kamphaeng Phet,Prachin Buri,11.82,8.56,45,5,44,6,0.9,50
Kamphaeng Phet,Rayong,10.294117647058824,6.764705882352941,17,0,14,3,1.0,17
Kamphaeng Phet,Roi Et,11.32,7.78,46,4,46,4,0.92,50
Kamphaeng Phet,Sa Kaeo,11.714285714285714,10.428571428571429,7,0,7,0,1.0,7
Kamphaeng Phet,Sakon Nakhon,11.216216216216216,8.45945945945946,36,1,34,3,0.972972972972973,37
Kamphaeng Phet,Samut Prakan,9.555555555555555,6.0,18,0,18,0,1.0,18
Kamphaeng Phet,Saraburi,13.666666666666666,10.866666666666667,40,5,41,4,0.8888888888888888,45
Kamphaeng Phet,Si Sa Ket,13.336538461538462,10.365384615384615,192,16,190,18,0.9230769230769231,208
Kamphaeng Phet,Sing Buri,9.5,6.583333333333333,12,0,10,2,1.0,12
Kamphaeng Phet,Surin,13.168831168831169,10.03896103896104,68,9,69,8,0.8831168831168831,77
Kamphaeng Phet,Trat,12.333333333333334,8.722222222222221,16,2,17,1,0.8888888888888888,18
Kamphaeng Phet,Ubon Ratchathani,11.340425531914894,8.46808510638298,44,3,41,6,0.9361702127659575,47
Kamphaeng Phet,Udon Thani,15.666666666666666,9.592592592592593,25,2,24,3,0.9259259259259259,27
Kamphaeng Phet,Yasothon,11.866666666666667,9.133333333333333,15,0,14,1,1.0,15
Kanchanaburi,Khon Kaen,24.285714285714285,7.571428571428571,6,1,6,1,0.8571428571428571,7
Kanchanaburi,Lampang,13.0,11.666666666666666,3,0,3,0,1.0,3
Kanchanaburi,Lamphun,19.5,16.0,1,1,2,0,0.5,2
Kanchanaburi,Loei,11.0,8.25,4,0,3,1,1.0,4
Kanchanaburi,Lop Buri,16.0,11.625,7,1,6,2,0.875,8
Kanchanaburi,Maha Sarakham,20.0,12.75,3,1,3,1,0.75,4
Kanchanaburi,Mukdahan,8.2,5.8,5,0,5,0,1.0,5
Kanchanaburi,Nakhon Nayok,10.333333333333334,8.444444444444445,9,0,9,0,1.0,9
Kanchanaburi,Nakhon Phanom,10.333333333333334,7.0,9,0,9,0,1.0,9
Kanchanaburi,Nakhon Ratchasima,9.181818181818182,6.363636363636363,11,0,8,3,1.0,11
Kanchanaburi,Nong Khai,13.0,12.0,1,0,1,0,1.0,1
Kanchanaburi,Nonthaburi,6.0,2.8,5,0,5,0,1.0,5
Kanchanaburi,Pathum Thani,15.0,12.714285714285714,6,1,7,0,0.8571428571428571,7
Kanchanaburi,Phra Nakhon Si Ayutthaya,7.25,5.75,4,0,4,0,1.0,4
Kanchanaburi,Prachin Buri,13.2,10.1,10,0,10,0,1.0,10
Kanchanaburi,Rayong,8.0,4.75,4,0,3,1,1.0,4
Kanchanaburi,Roi Et,9.555555555555555,7.148148148148148,27,0,26,1,1.0,27
Kanchanaburi,Sa Kaeo,8.0,6.0,1,0,1,0,1.0,1
Kanchanaburi,Sakon Nakhon,11.88888888888889,9.333333333333334,9,0,9,0,1.0,9
Kanchanaburi,Samut Prakan,12.5,11.5,1,1,2,0,0.5,2
Kanchanaburi,Saraburi,13.95,11.2,19,1,19,1,0.95,20
Kanchanaburi,Si Sa Ket,16.132075471698112,12.037735849056604,46,7,45,8,0.8679245283018868,53
Kanchanaburi,Sing Buri,7.0,5.75,4,0,4,0,1.0,4
Kanchanaburi,Surin,11.310344827586206,9.03448275862069,28,1,29,0,0.9655172413793104,29
Kanchanaburi,Trat,7.5,5.166666666666667,6,0,6,0,1.0,6
Kanchanaburi,Ubon Ratchathani,14.346153846153847,11.73076923076923,25,1,26,0,0.9615384615384616,26
Kanchanaburi,Udon Thani,8.5,4.0,2,0,2,0,1.0,2
Kanchanaburi,Yasothon,10.4,8.2,5,0,5,0,1.0,5
Khon Kaen,Khon Kaen,10.75,8.041666666666666,23,1,21,3,0.9583333333333334,24
Khon Kaen,Krabi,7.333333333333333,5.866666666666666,15,0,15,0,1.0,15
Khon Kaen,Lampang,11.06,7.98,47,3,44,6,0.94,50
Khon Kaen,Lamphun,11.03125,7.53125,32,0,29,3,1.0,32
Khon Kaen,Loei,6.8,4.1,19,1,17,3,0.95,20
Khon Kaen,Lop Buri,10.5,7.482142857142857,54,2,48,8,0.9642857142857143,56
Khon Kaen,Maha Sarakham,12.08148148148148,9.4,116,19,124,11,0.8592592592592593,135
Khon Kaen,Mukdahan,9.85483870967742,7.193548387096774,60,2,60,2,0.967741935483871,62
Khon Kaen,Nakhon Nayok,11.282051282051283,8.282051282051283,36,3,37,2,0.9230769230769231,39
Khon Kaen,Nakhon Pathom,10.227272727272727,7.681818181818182,19,3,20,2,0.8636363636363636,22
Khon Kaen,Nakhon Phanom,10.054263565891473,7.162790697674419,124,5,116,13,0.9612403100775194,129
Khon Kaen,Nakhon Ratchasima,13.211822660098521,9.793103448275861,171,32,187,16,0.8423645320197044,203
Khon Kaen,Nakhon Sawan,13.807692307692308,9.73076923076923,24,2,25,1,0.9230769230769231,26
Khon Kaen,Nakhon Si Thammarat,5.25,3.375,8,0,8,0,1.0,8
Khon Kaen,Narathiwat,10.272727272727273,7.7272727272727275,11,0,9,2,1.0,11
Khon Kaen,Nong Khai,10.428571428571429,7.285714285714286,13,1,11,3,0.9285714285714286,14
Khon Kaen,Nonthaburi,10.576923076923077,6.653846153846154,22,4,23,3,0.8461538461538461,26
Khon Kaen,Pathum Thani,11.772727272727273,8.590909090909092,21,1,18,4,0.9545454545454546,22
Khon Kaen,Pattani,9.394736842105264,7.2894736842105265,36,2,37,1,0.9473684210526315,38
Khon Kaen,Phangnga,16.166666666666668,11.0,5,1,6,0,0.8333333333333334,6
Khon Kaen,Phatthalung,17.2,13.8,8,2,10,0,0.8,10
Khon Kaen,Phetchaburi,8.466666666666667,4.8,14,1,13,2,0.9333333333333333,15
Khon Kaen,Phra Nakhon Si Ayutthaya,7.2926829268292686,5.365853658536586,40,1,39,2,0.975609756097561,41
Khon Kaen,Phrae,10.125,7.375,16,0,16,0,1.0,16
Khon Kaen,Phuket,6.0,3.5,2,0,2,0,1.0,2
Khon Kaen,Prachin Buri,11.21875,7.739583333333333,89,7,83,13,0.9270833333333334,96
Khon Kaen,Prachuap Khiri Khan,11.166666666666666,8.055555555555555,15,3,16,2,0.8333333333333334,18
Khon Kaen,Ranong,5.5,3.1666666666666665,6,0,5,1,1.0,6
Khon Kaen,Ratchaburi,10.48,8.08,23,2,24,1,0.92,25
Khon Kaen,Rayong,10.90625,8.375,28,4,30,2,0.875,32
Khon Kaen,Roi Et,10.768907563025211,7.9411764705882355,223,15,224,14,0.9369747899159664,238
Khon Kaen,Sa Kaeo,11.8125,7.458333333333333,40,8,44,4,0.8333333333333334,48
Khon Kaen,Sakon Nakhon,10.92,8.6,141,9,143,7,0.94,150
Khon Kaen,Samut Prakan,12.0,9.5,28,2,30,0,0.9333333333333333,30
Khon Kaen,Samut Sakhon,11.4375,6.0625,16,0,15,1,1.0,16
Khon Kaen,Samut Songkhram,10.89655172413793,7.689655172413793,26,3,25,4,0.896551724137931,29
Khon Kaen,Saraburi,9.225352112676056,6.661971830985915,67,4,68,3,0.9436619718309859,71
Khon Kaen,Satun,8.285714285714286,5.571428571428571,7,0,6,1,1.0,7
Khon Kaen,Si Sa Ket,11.832402234636872,8.932960893854748,328,30,324,34,0.9162011173184358,358
Khon Kaen,Sing Buri,7.565217391304348,5.608695652173913,22,1,23,0,0.9565217391304348,23
Khon Kaen,Songkhla,8.25,5.666666666666667,11,1,12,0,0.9166666666666666,12
Khon Kaen,Sukhothai,8.857142857142858,6.428571428571429,6,1,7,0,0.8571428571428571,7
Khon Kaen,Suphan Buri,17.555555555555557,14.777777777777779,6,3,9,0,0.6666666666666666,9
Khon Kaen,Surat Thani,6.0,6.0,1,0,1,0,1.0,1
Khon Kaen,Surin,11.379310344827585,8.068965517241379,162,12,163,11,0.9310344827586207,174
Khon Kaen,Tak,9.416666666666666,7.25,12,0,12,0,1.0,12
Khon Kaen,Trang,7.5,6.166666666666667,6,0,6,0,1.0,6
Khon Kaen,Trat,11.036363636363637,7.636363636363637,52,3,47,8,0.9454545454545454,55
Khon Kaen,Ubon Ratchathani,10.261194029850746,7.462686567164179,126,8,125,9,0.9402985074626866,134
Khon Kaen,Udon Thani,10.511627906976743,7.093023255813954,41,2,38,5,0.9534883720930233,43
Khon Kaen,Uthai Thani,11.692307692307692,7.846153846153846,25,1,24,2,0.9615384615384616,26
Khon Kaen,Uttaradit,8.25,6.0625,16,0,16,0,1.0,16
Khon Kaen,Yala,13.0,11.0,2,0,2,0,1.0,2
Khon Kaen,Yasothon,10.483333333333333,7.033333333333333,57,3,54,6,0.95,60
Krabi,Lampang,9.714285714285714,6.142857142857143,7,0,7,0,1.0,7
Krabi,Lamphun,13.333333333333334,10.666666666666666,3,0,3,0,1.0,3
Krabi,Loei,15.727272727272727,12.363636363636363,10,1,10,1,0.9090909090909091,11
Krabi,Lop Buri,13.647058823529411,10.882352941176471,15,2,15,2,0.8823529411764706,17
Krabi,Maha Sarakham,12.55,9.75,19,1,18,2,0.95,20
Krabi,Mukdahan,18.142857142857142,13.285714285714286,6,1,6,1,0.8571428571428571,7
Krabi,Nakhon Nayok,9.571428571428571,8.285714285714286,7,0,7,0,1.0,7
Krabi,Nakhon Phanom,12.833333333333334,9.555555555555555,15,3,16,2,0.8333333333333334,18
Krabi,Nakhon Ratchasima,11.772727272727273,7.590909090909091,21,1,20,2,0.9545454545454546,22
Krabi,Nong Khai,8.25,6.5,8,0,7,1,1.0,8
Krabi,Nonthaburi,12.75,7.5,4,0,3,1,1.0,4
Krabi,Pathum Thani,16.0,10.333333333333334,10,2,8,4,0.8333333333333334,12
Krabi,Phra Nakhon Si Ayutthaya,11.526315789473685,7.684210526315789,19,0,16,3,1.0,19
Krabi,Prachin Buri,11.272727272727273,8.181818181818182,21,1,20,2,0.9545454545454546,22
Krabi,Rayong,11.4,9.933333333333334,14,1,15,0,0.9333333333333333,15
Krabi,Roi Et,10.757575757575758,7.424242424242424,30,3,31,2,0.9090909090909091,33
Krabi,Sa Kaeo,7.0,6.0,1,1,2,0,0.5,2
Krabi,Sakon Nakhon,10.464285714285714,8.214285714285714,27,1,27,1,0.9642857142857143,28
Krabi,Samut Prakan,12.857142857142858,10.857142857142858,6,1,7,0,0.8571428571428571,7
Krabi,Saraburi,11.117647058823529,8.411764705882353,30,4,31,3,0.8823529411764706,34
Krabi,Si Sa Ket,12.661290322580646,9.92741935483871,115,9,117,7,0.9274193548387096,124
Krabi,Sing Buri,10.222222222222221,7.888888888888889,9,0,9,0,1.0,9
Krabi,Surin,12.48,9.52,45,5,46,4,0.9,50
Krabi,Trat,11.0,8.8,10,0,9,1,1.0,10
Krabi,Ubon Ratchathani,11.59375,7.84375,31,1,27,5,0.96875,32
Krabi,Udon Thani,15.105263157894736,10.368421052631579,17,2,17,2,0.8947368421052632,19
Krabi,Yasothon,12.428571428571429,8.571428571428571,7,0,6,1,1.0,7
Lampang,Lampang,9.416666666666666,7.5,12,0,11,1,1.0,12
Lampang,Lamphun,14.421052631578947,9.105263157894736,18,1,18,1,0.9473684210526315,19
Lampang,Loei,10.307692307692308,7.038461538461538,23,3,24,2,0.8846153846153846,26
Lampang,Lop Buri,11.306122448979592,8.183673469387756,47,2,38,11,0.9591836734693877,49
Lampang,Maha Sarakham,10.54368932038835,7.70873786407767,92,11,86,17,0.8932038834951457,103
Lampang,Mukdahan,11.066666666666666,7.933333333333334,29,1,30,0,0.9666666666666667,30
Lampang,Nakhon Nayok,11.44186046511628,7.534883720930233,42,1,37,6,0.9767441860465116,43
Lampang,Nakhon Pathom,10.0,5.166666666666667,5,1,4,2,0.8333333333333334,6
Lampang,Nakhon Phanom,12.85,8.2375,70,10,72,8,0.875,80
Lampang,Nakhon Ratchasima,12.279661016949152,9.313559322033898,109,9,103,15,0.923728813559322,118
Lampang,Nakhon Sawan,7.571428571428571,5.0,7,0,7,0,1.0,7
Lampang,Nakhon Si Thammarat,6.8,5.8,10,0,10,0,1.0,10
Lampang,Narathiwat,10.666666666666666,9.0,3,0,3,0,1.0,3
Lampang,Nong Khai,8.857142857142858,6.25,27,1,27,1,0.9642857142857143,28
Lampang,Nonthaburi,14.3,12.05,17,3,18,2,0.85,20
Lampang,Pathum Thani,13.64,10.68,23,2,22,3,0.92,25
Lampang,Pattani,9.0625,6.5625,30,2,30,2,0.9375,32
Lampang,Phangnga,18.0,17.0,1,0,1,0,1.0,1
Lampang,Phatthalung,10.0,8.3,10,0,8,2,1.0,10
Lampang,Phetchaburi,11.25,6.75,4,0,4,0,1.0,4
Lampang,Phra Nakhon Si Ayutthaya,8.933333333333334,6.266666666666667,28,2,29,1,0.9333333333333333,30
Lampang,Phrae,15.583333333333334,8.166666666666666,11,1,10,2,0.9166666666666666,12
Lampang,Phuket,12.0,9.333333333333334,3,0,3,0,1.0,3
Lampang,Prachin Buri,10.892857142857142,7.321428571428571,51,5,50,6,0.9107142857142857,56
Lampang,Prachuap Khiri Khan,10.0,5.2,4,1,5,0,0.8,5
Lampang,Ranong,13.0,7.090909090909091,11,0,9,2,1.0,11
Lampang,Ratchaburi,11.666666666666666,8.666666666666666,6,0,6,0,1.0,6
Lampang,Rayong,10.857142857142858,7.771428571428571,34,1,35,0,0.9714285714285714,35
Lampang,Roi Et,10.850393700787402,7.732283464566929,118,9,116,11,0.9291338582677166,127
Lampang,Sa Kaeo,10.583333333333334,7.375,23,1,19,5,0.9583333333333334,24
Lampang,Sakon Nakhon,10.857142857142858,8.151785714285714,100,12,104,8,0.8928571428571429,112
Lampang,Samut Prakan,7.826086956521739,5.478260869565218,20,3,22,1,0.8695652173913043,23
Lampang,Samut Sakhon,6.666666666666667,2.5,6,0,3,3,1.0,6
Lampang,Samut Songkhram,11.909090909090908,9.090909090909092,10,1,9,2,0.9090909090909091,11
Lampang,Saraburi,9.854166666666666,7.041666666666667,48,0,44,4,1.0,48
Lampang,Satun,8.857142857142858,5.428571428571429,7,0,5,2,1.0,7
Lampang,Si Sa Ket,11.007782101167315,8.221789883268482,234,23,230,27,0.9105058365758755,257
Lampang,Sing Buri,9.0,6.625,16,0,12,4,1.0,16
Lampang,Songkhla,12.0,9.333333333333334,9,0,9,0,1.0,9
Lampang,Sukhothai,15.333333333333334,12.666666666666666,2,1,2,1,0.6666666666666666,3
Lampang,Suphan Buri,13.666666666666666,8.333333333333334,5,1,5,1,0.8333333333333334,6
Lampang,Surat Thani,10.5,8.0,2,0,2,0,1.0,2
Lampang,Surin,11.53956834532374,8.525179856115107,129,10,132,7,0.9280575539568345,139
Lampang,Tak,11.666666666666666,8.444444444444445,7,2,7,2,0.7777777777777778,9
Lampang,Trat,10.131578947368421,7.342105263157895,36,2,35,3,0.9473684210526315,38
Lampang,Ubon Ratchathani,12.032520325203253,8.991869918699187,111,12,113,10,0.9024390243902439,123
Lampang,Udon Thani,15.826086956521738,10.23913043478261,43,3,33,13,0.9347826086956522,46
Lampang,Uthai Thani,9.416666666666666,7.833333333333333,10,2,11,1,0.8333333333333334,12
Lampang,Uttaradit,10.6,7.9,10,0,8,2,1.0,10
Lampang,Yala,9.0,2.0,0,1,0,1,0.0,1
Lampang,Yasothon,11.851851851851851,7.2407407407407405,52,2,46,8,0.9629629629629629,54
Lamphun,Lamphun,5.666666666666667,3.0,3,0,3,0,1.0,3
Lamphun,Loei,14.944444444444445,12.722222222222221,12,6,18,0,0.6666666666666666,18
Lamphun,Lop Buri,16.022727272727273,10.681818181818182,38,6,37,7,0.8636363636363636,44
Lamphun,Maha Sarakham,12.24,9.52,46,4,46,4,0.92,50
Lamphun,Mukdahan,16.266666666666666,13.666666666666666,13,2,15,0,0.8666666666666667,15
Lamphun,Nakhon Nayok,13.0,10.222222222222221,9,0,8,1,1.0,9
Lamphun,Nakhon Pathom,5.0,4.0,1,0,1,0,1.0,1
Lamphun,Nakhon Phanom,11.7,8.133333333333333,29,1,28,2,0.9666666666666667,30
Lamphun,Nakhon Ratchasima,12.08955223880597,9.059701492537313,61,6,59,8,0.9104477611940298,67
Lamphun,Nakhon Sawan,8.0,7.0,3,0,3,0,1.0,3
Lamphun,Nakhon Si Thammarat,6.5,5.0,2,0,2,0,1.0,2
Lamphun,Narathiwat,7.0,5.0,2,0,2,0,1.0,2
Lamphun,Nong Khai,9.142857142857142,6.142857142857143,14,0,11,3,1.0,14
Lamphun,Nonthaburi,16.0,13.0,4,1,5,0,0.8,5
Lamphun,Pathum Thani,19.142857142857142,16.357142857142858,13,1,13,1,0.9285714285714286,14
Lamphun,Pattani,8.625,5.5625,15,1,15,1,0.9375,16
Lamphun,Phangnga,22.0,17.0,2,1,2,1,0.6666666666666666,3
Lamphun,Phatthalung,11.5,7.0,2,0,2,0,1.0,2
Lamphun,Phetchaburi,5.0,4.0,1,0,1,0,1.0,1
Lamphun,Phra Nakhon Si Ayutthaya,12.08,9.2,25,0,25,0,1.0,25
Lamphun,Phrae,18.0,14.75,3,1,4,0,0.75,4
Lamphun,Prachin Buri,13.023255813953488,10.511627906976743,36,7,41,2,0.8372093023255814,43
Lamphun,Prachuap Khiri Khan,24.0,21.0,2,0,2,0,1.0,2
Lamphun,Ranong,15.0,7.0,2,0,0,2,1.0,2
Lamphun,Ratchaburi,11.5,8.5,4,0,4,0,1.0,4
Lamphun,Rayong,16.181818181818183,13.318181818181818,17,5,20,2,0.7727272727272727,22
Lamphun,Roi Et,14.036144578313253,10.590361445783133,73,10,73,10,0.8795180722891566,83
Lamphun,Sa Kaeo,17.5,15.071428571428571,11,3,14,0,0.7857142857142857,14
Lamphun,Sakon Nakhon,10.91044776119403,8.417910447761194,65,2,61,6,0.9701492537313433,67
Lamphun,Samut Prakan,12.954545454545455,9.409090909090908,22,0,21,1,1.0,22
Lamphun,Samut Sakhon,9.0,8.0,2,0,2,0,1.0,2
Lamphun,Samut Songkhram,7.8,6.0,5,0,5,0,1.0,5
Lamphun,Saraburi,11.416666666666666,8.666666666666666,55,5,56,4,0.9166666666666666,60
Lamphun,Satun,14.428571428571429,11.571428571428571,7,0,7,0,1.0,7
Lamphun,Si Sa Ket,12.730337078651685,9.98876404494382,162,16,164,14,0.9101123595505618,178
Lamphun,Sing Buri,11.571428571428571,7.0,14,0,13,1,1.0,14
Lamphun,Songkhla,10.0,6.5,2,0,2,0,1.0,2
Lamphun,Suphan Buri,7.25,4.5,4,0,4,0,1.0,4
Lamphun,Surat Thani,14.0,10.0,2,0,2,0,1.0,2
Lamphun,Surin,12.895348837209303,9.186046511627907,80,6,77,9,0.9302325581395349,86
Lamphun,Tak,24.25,21.75,3,1,4,0,0.75,4
Lamphun,Trang,6.0,5.0,1,0,1,0,1.0,1
Lamphun,Trat,12.0,9.291666666666666,22,2,21,3,0.9166666666666666,24
Lamphun,Ubon Ratchathani,12.756410256410257,9.987179487179487,69,9,72,6,0.8846153846153846,78
Lamphun,Udon Thani,13.823529411764707,7.852941176470588,33,1,30,4,0.9705882352941176,34
Lamphun,Uthai Thani,13.0,10.4,5,0,4,1,1.0,5
Lamphun,Uttaradit,9.333333333333334,5.333333333333333,3,0,3,0,1.0,3
Lamphun,Yasothon,9.818181818181818,7.545454545454546,22,0,22,0,1.0,22
Loei,Loei,11.333333333333334,8.333333333333334,6,0,6,0,1.0,6
Loei,Lop Buri,11.333333333333334,9.047619047619047,20,1,20,1,0.9523809523809523,21
Loei,Maha Sarakham,10.126984126984127,7.349206349206349,63,0,58,5,1.0,63
Loei,Mukdahan,14.733333333333333,11.633333333333333,25,5,27,3,0.8333333333333334,30
Loei,Nakhon Nayok,14.233333333333333,10.466666666666667,27,3,22,8,0.9,30
Loei,Nakhon Pathom,9.071428571428571,6.071428571428571,14,0,13,1,1.0,14
Loei,Nakhon Phanom,10.738461538461538,7.7384615384615385,63,2,60,5,0.9692307692307692,65
Loei,Nakhon Ratchasima,12.214285714285714,9.153061224489797,90,8,90,8,0.9183673469387755,98
Loei,Nakhon Sawan,15.142857142857142,10.785714285714286,12,2,11,3,0.8571428571428571,14
Loei,Nakhon Si Thammarat,10.166666666666666,6.666666666666667,6,0,4,2,1.0,6
Loei,Narathiwat,8.5,5.25,4,0,4,0,1.0,4
Loei,Nong Khai,18.25,15.5,6,2,8,0,0.75,8
Loei,Nonthaburi,11.692307692307692,7.3076923076923075,13,0,11,2,1.0,13
Loei,Pathum Thani,10.88888888888889,6.888888888888889,9,0,8,1,1.0,9
Loei,Pattani,11.0,8.478260869565217,22,1,21,2,0.9565217391304348,23
Loei,Phatthalung,14.571428571428571,12.0,6,1,7,0,0.8571428571428571,7
Loei,Phetchaburi,10.857142857142858,8.0,7,0,7,0,1.0,7
Loei,Phra Nakhon Si Ayutthaya,9.5,6.416666666666667,11,1,10,2,0.9166666666666666,12
Loei,Phrae,14.076923076923077,9.0,11,2,10,3,0.8461538461538461,13
Loei,Phuket,9.0,7.0,1,0,1,0,1.0,1
Loei,Prachin Buri,9.24074074074074,6.648148148148148,52,2,53,1,0.9629629629629629,54
Loei,Prachuap Khiri Khan,8.5,5.388888888888889,18,0,15,3,1.0,18
Loei,Ranong,14.4,12.0,4,1,5,0,0.8,5
Loei,Ratchaburi,9.11111111111111,6.611111111111111,17,1,17,1,0.9444444444444444,18
Loei,Rayong,12.1875,8.375,15,1,13,3,0.9375,16
Loei,Roi Et,14.0,10.69,89,11,89,11,0.89,100
Loei,Sa Kaeo,12.0,8.833333333333334,24,0,21,3,1.0,24
Loei,Sakon Nakhon,11.197368421052632,8.18421052631579,75,1,67,9,0.9868421052631579,76
Loei,Samut Prakan,8.0,4.785714285714286,14,0,12,2,1.0,14
Loei,Samut Sakhon,13.0,7.5,4,0,4,0,1.0,4
Loei,Samut Songkhram,11.7,8.6,9,1,7,3,0.9,10
Loei,Saraburi,8.9375,5.3125,15,1,14,2,0.9375,16
Loei,Satun,11.5,9.166666666666666,6,0,6,0,1.0,6
Loei,Si Sa Ket,10.4296875,7.453125,118,10,120,8,0.921875,128
Loei,Sing Buri,9.5,7.125,8,0,8,0,1.0,8
Loei,Songkhla,14.25,12.625,8,0,7,1,1.0,8
Loei,Sukhothai,13.285714285714286,9.285714285714286,6,1,5,2,0.8571428571428571,7
Loei,Suphan Buri,11.4,9.6,5,0,5,0,1.0,5
Loei,Surat Thani,13.8,10.0,5,0,4,1,1.0,5
Loei,Surin,12.028169014084508,8.464788732394366,66,5,60,11,0.9295774647887324,71
Loei,Tak,12.25,8.75,12,0,10,2,1.0,12
Loei,Trang,23.0,18.75,3,1,4,0,0.75,4
Loei,Trat,11.842105263157896,8.894736842105264,16,3,18,1,0.8421052631578947,19
Loei,Ubon Ratchathani,13.014705882352942,9.470588235294118,64,4,60,8,0.9411764705882353,68
Loei,Udon Thani,11.470588235294118,5.882352941176471,15,2,15,2,0.8823529411764706,17
Loei,Uthai Thani,10.9375,8.375,16,0,16,0,1.0,16
Loei,Uttaradit,9.0,6.0,6,0,5,1,1.0,6
Loei,Yala,19.0,9.0,1,0,0,1,1.0,1
Loei,Yasothon,10.742857142857142,8.514285714285714,34,1,34,1,0.9714285714285714,35
Lop Buri,Lop Buri,10.11111111111111,7.055555555555555,17,1,15,3,0.9444444444444444,18
Lop Buri,Maha Sarakham,11.695652173913043,8.644927536231885,127,11,125,13,0.9202898550724637,138
Lop Buri,Mukdahan,10.818181818181818,8.376623376623376,72,5,72,5,0.935064935064935,77
Lop Buri,Nakhon Nayok,10.866666666666667,7.25,58,2,54,6,0.9666666666666667,60
Lop Buri,Nakhon Pathom,9.214285714285714,6.857142857142857,28,0,27,1,1.0,28
Lop Buri,Nakhon Phanom,10.025974025974026,7.363636363636363,146,8,143,11,0.948051948051948,154
Lop Buri,Nakhon Ratchasima,12.058558558558559,8.707207207207206,194,28,196,26,0.8738738738738738,222
Lop Buri,Nakhon Sawan,12.857142857142858,9.738095238095237,42,0,40,2,1.0,42
Lop Buri,Nakhon Si Thammarat,11.105263157894736,9.0,17,2,18,1,0.8947368421052632,19
Lop Buri,Narathiwat,10.76923076923077,8.0,13,0,12,1,1.0,13
Lop Buri,Nong Khai,6.846153846153846,4.923076923076923,13,0,13,0,1.0,13
Lop Buri,Nonthaburi,9.821428571428571,6.107142857142857,27,1,21,7,0.9642857142857143,28
Lop Buri,Pathum Thani,13.631578947368421,10.052631578947368,14,5,16,3,0.7368421052631579,19
Lop Buri,Pattani,10.619047619047619,8.015873015873016,58,5,59,4,0.9206349206349206,63
Lop Buri,Phangnga,9.1,6.3,10,0,9,1,1.0,10
Lop Buri,Phatthalung,11.0,5.666666666666667,16,2,12,6,0.8888888888888888,18
Lop Buri,Phetchaburi,10.363636363636363,7.2272727272727275,22,0,21,1,1.0,22
Lop Buri,Phra Nakhon Si Ayutthaya,10.32,7.32,25,0,23,2,1.0,25
Lop Buri,Phrae,10.3,6.6,29,1,25,5,0.9666666666666667,30
Lop Buri,Phuket,10.25,7.375,8,0,7,1,1.0,8
Lop Buri,Prachin Buri,11.953488372093023,8.86046511627907,80,6,76,10,0.9302325581395349,86
Lop Buri,Prachuap Khiri Khan,9.142857142857142,6.892857142857143,27,1,27,1,0.9642857142857143,28
Lop Buri,Ranong,6.75,2.6666666666666665,12,0,9,3,1.0,12
Lop Buri,Ratchaburi,11.783783783783784,9.054054054054054,31,6,35,2,0.8378378378378378,37
Lop Buri,Rayong,9.303030303030303,6.96969696969697,32,1,31,2,0.9696969696969697,33
Lop Buri,Roi Et,10.961904761904762,7.90952380952381,197,13,189,21,0.9380952380952381,210
Lop Buri,Sa Kaeo,11.661971830985916,9.23943661971831,61,10,65,6,0.8591549295774648,71
Lop Buri,Sakon Nakhon,10.202898550724637,7.144927536231884,198,9,179,28,0.9565217391304348,207
Lop Buri,Samut Prakan,9.606060606060606,5.878787878787879,31,2,28,5,0.9393939393939394,33
Lop Buri,Samut Sakhon,10.736842105263158,8.052631578947368,18,1,16,3,0.9473684210526315,19
Lop Buri,Samut Songkhram,10.32,7.4,23,2,21,4,0.92,25
Lop Buri,Saraburi,9.18918918918919,6.054054054054054,37,0,31,6,1.0,37
Lop Buri,Satun,9.222222222222221,7.111111111111111,9,0,8,1,1.0,9
Lop Buri,Si Sa Ket,10.75206611570248,7.743801652892562,229,13,222,20,0.9462809917355371,242
Lop Buri,Sing Buri,11.909090909090908,8.636363636363637,10,1,11,0,0.9090909090909091,11
Lop Buri,Songkhla,11.576923076923077,9.0,23,3,25,1,0.8846153846153846,26
Lop Buri,Sukhothai,13.181818181818182,11.272727272727273,7,4,11,0,0.6363636363636364,11
Lop Buri,Suphan Buri,14.0,10.833333333333334,10,2,11,1,0.8333333333333334,12
Lop Buri,Surat Thani,12.692307692307692,10.538461538461538,11,2,13,0,0.8461538461538461,13
Lop Buri,Surin,11.370689655172415,8.28448275862069,105,11,104,12,0.9051724137931034,116
Lop Buri,Tak,10.863636363636363,7.7272727272727275,21,1,19,3,0.9545454545454546,22
Lop Buri,Trang,12.777777777777779,7.777777777777778,8,1,8,1,0.8888888888888888,9
Lop Buri,Trat,12.755102040816327,9.10204081632653,47,2,45,4,0.9591836734693877,49
Lop Buri,Ubon Ratchathani,12.34375,9.296875,173,19,180,12,0.9010416666666666,192
Lop Buri,Udon Thani,11.185185185185185,7.703703703703703,24,3,27,0,0.8888888888888888,27
Lop Buri,Uthai Thani,13.454545454545455,10.727272727272727,28,5,32,1,0.8484848484848485,33
Lop Buri,Uttaradit,7.275862068965517,4.896551724137931,29,0,27,2,1.0,29
Lop Buri,Yala,3.0,1.0,2,0,2,0,1.0,2
Lop Buri,Yasothon,12.11111111111111,9.518518518518519,75,6,74,7,0.9259259259259259,81
Maha Sarakham,Maha Sarakham,12.345794392523365,8.91588785046729,90,17,94,13,0.8411214953271028,107
Maha Sarakham,Mukdahan,12.417582417582418,8.274725274725276,77,14,76,15,0.8461538461538461,91
Maha Sarakham,Nakhon Nayok,12.578125,8.953125,57,7,57,7,0.890625,64
Maha Sarakham,Nakhon Pathom,11.368421052631579,8.157894736842104,18,1,17,2,0.9473684210526315,19
Maha Sarakham,Nakhon Phanom,11.62135922330097,8.849514563106796,182,24,186,20,0.883495145631068,206
Maha Sarakham,Nakhon Ratchasima,11.830670926517572,8.626198083067093,292,21,276,37,0.9329073482428115,313
Maha Sarakham,Nakhon Sawan,11.107142857142858,8.071428571428571,26,2,24,4,0.9285714285714286,28
Maha Sarakham,Nakhon Si Thammarat,11.95,7.85,19,1,18,2,0.95,20
Maha Sarakham,Narathiwat,11.384615384615385,7.846153846153846,13,0,8,5,1.0,13
Maha Sarakham,Nong Khai,11.075,8.5875,75,5,73,7,0.9375,80
Maha Sarakham,Nonthaburi,16.70909090909091,12.072727272727272,42,13,43,12,0.7636363636363637,55
Maha Sarakham,Pathum Thani,13.563218390804598,9.517241379310345,71,16,69,18,0.8160919540229885,87
Maha Sarakham,Pattani,10.75,7.9423076923076925,47,5,46,6,0.9038461538461539,52
Maha Sarakham,Phangnga,13.7,11.1,9,1,10,0,0.9,10
Maha Sarakham,Phatthalung,11.555555555555555,6.666666666666667,9,0,7,2,1.0,9
Maha Sarakham,Phetchaburi,12.416666666666666,8.625,21,3,21,3,0.875,24
Maha Sarakham,Phra Nakhon Si Ayutthaya,12.257142857142858,8.8,93,12,97,8,0.8857142857142857,105
Maha Sarakham,Phrae,12.275862068965518,7.551724137931035,24,5,22,7,0.8275862068965517,29
Maha Sarakham,Phuket,9.285714285714286,7.428571428571429,7,0,7,0,1.0,7
Maha Sarakham,Prachin Buri,12.8,9.313513513513513,158,27,164,21,0.8540540540540541,185
Maha Sarakham,Prachuap Khiri Khan,11.96551724137931,7.448275862068965,29,0,23,6,1.0,29
Maha Sarakham,Ranong,9.142857142857142,6.761904761904762,20,1,20,1,0.9523809523809523,21
Maha Sarakham,Ratchaburi,9.478260869565217,7.391304347826087,21,2,22,1,0.9130434782608695,23
Maha Sarakham,Rayong,11.29203539823009,7.787610619469026,110,3,88,25,0.9734513274336283,113
Maha Sarakham,Roi Et,10.528610354223433,7.26158038147139,341,26,329,38,0.9291553133514986,367
Maha Sarakham,Sa Kaeo,11.409090909090908,8.590909090909092,62,4,59,7,0.9393939393939394,66
Maha Sarakham,Sakon Nakhon,13.05281690140845,10.225352112676056,264,20,266,18,0.9295774647887324,284
Maha Sarakham,Samut Prakan,8.359375,6.140625,63,1,59,5,0.984375,64
Maha Sarakham,Samut Sakhon,9.272727272727273,3.272727272727273,10,1,9,2,0.9090909090909091,11
Maha Sarakham,Samut Songkhram,14.7,10.15,19,1,16,4,0.95,20
Maha Sarakham,Saraburi,10.730392156862745,8.186274509803921,188,16,198,6,0.9215686274509803,204
Maha Sarakham,Satun,9.916666666666666,7.75,12,0,11,1,1.0,12
Maha Sarakham,Si Sa Ket,13.443765281173594,10.09046454767726,731,87,725,93,0.8936430317848411,818
Maha Sarakham,Sing Buri,11.323076923076924,8.569230769230769,62,3,58,7,0.9538461538461539,65
Maha Sarakham,Songkhla,11.1,8.7,10,0,10,0,1.0,10
Maha Sarakham,Sukhothai,9.166666666666666,6.5,12,0,12,0,1.0,12
Maha Sarakham,Suphan Buri,10.083333333333334,7.166666666666667,10,2,11,1,0.8333333333333334,12
Maha Sarakham,Surat Thani,21.6,16.6,9,1,7,3,0.9,10
Maha Sarakham,Surin,12.12997347480106,8.39787798408488,341,36,341,36,0.9045092838196287,377
Maha Sarakham,Tak,9.5625,7.3125,15,1,15,1,0.9375,16
Maha Sarakham,Trang,8.857142857142858,6.571428571428571,12,2,12,2,0.8571428571428571,14
Maha Sarakham,Trat,13.554455445544555,10.455445544554456,86,15,85,16,0.8514851485148515,101
Maha Sarakham,Ubon Ratchathani,12.084905660377359,9.440251572327044,283,35,291,27,0.889937106918239,318
Maha Sarakham,Udon Thani,12.387596899224807,8.294573643410853,115,14,113,16,0.8914728682170543,129
Maha Sarakham,Uthai Thani,11.172413793103448,8.413793103448276,27,2,28,1,0.9310344827586207,29
Maha Sarakham,Uttaradit,12.875,10.1875,15,1,15,1,0.9375,16
Maha Sarakham,Yala,9.5,8.0,4,0,4,0,1.0,4
Maha Sarakham,Yasothon,12.212389380530974,9.424778761061948,105,8,103,10,0.9292035398230089,113
Mukdahan,Mukdahan,9.2,5.96,23,2,21,4,0.92,25
Mukdahan,Nakhon Nayok,12.306122448979592,9.204081632653061,45,4,45,4,0.9183673469387755,49
Mukdahan,Nakhon Pathom,14.142857142857142,9.142857142857142,6,1,6,1,0.8571428571428571,7
Mukdahan,Nakhon Phanom,13.291666666666666,9.625,84,12,85,11,0.875,96
Mukdahan,Nakhon Ratchasima,13.1796875,9.375,121,7,110,18,0.9453125,128
Mukdahan,Nakhon Sawan,10.0,8.2,5,0,5,0,1.0,5
Mukdahan,Nakhon Si Thammarat,6.2,4.8,5,0,5,0,1.0,5
Mukdahan,Narathiwat,5.0,5.0,1,0,1,0,1.0,1
Mukdahan,Nong Khai,10.423076923076923,7.615384615384615,26,0,23,3,1.0,26
Mukdahan,Nonthaburi,11.38888888888889,7.388888888888889,17,1,15,3,0.9444444444444444,18
Mukdahan,Pathum Thani,12.0,8.363636363636363,28,5,27,6,0.8484848484848485,33
Mukdahan,Pattani,13.652173913043478,10.304347826086957,20,3,22,1,0.8695652173913043,23
Mukdahan,Phangnga,15.333333333333334,8.666666666666666,2,1,2,1,0.6666666666666666,3
Mukdahan,Phatthalung,10.2,7.6,9,1,9,1,0.9,10
Mukdahan,Phetchaburi,11.5,6.333333333333333,5,1,4,2,0.8333333333333334,6
Mukdahan,Phra Nakhon Si Ayutthaya,12.454545454545455,8.666666666666666,30,3,29,4,0.9090909090909091,33
Mukdahan,Phrae,15.666666666666666,13.333333333333334,2,1,3,0,0.6666666666666666,3
Mukdahan,Phuket,19.666666666666668,13.666666666666666,2,1,2,1,0.6666666666666666,3
Mukdahan,Prachin Buri,11.916666666666666,8.777777777777779,67,5,68,4,0.9305555555555556,72
Mukdahan,Prachuap Khiri Khan,4.428571428571429,4.0,7,0,7,0,1.0,7
Mukdahan,Ranong,21.0,17.666666666666668,3,0,3,0,1.0,3
Mukdahan,Ratchaburi,10.9375,7.8125,15,1,14,2,0.9375,16
Mukdahan,Rayong,13.833333333333334,10.979166666666666,43,5,45,3,0.8958333333333334,48
Mukdahan,Roi Et,11.71951219512195,8.213414634146341,146,18,146,18,0.8902439024390244,164
Mukdahan,Sa Kaeo,9.956521739130435,5.6521739130434785,19,4,20,3,0.8260869565217391,23
Mukdahan,Sakon Nakhon,12.1651376146789,9.128440366972477,97,12,100,9,0.8899082568807339,109
Mukdahan,Samut Prakan,9.485714285714286,5.6571428571428575,33,2,32,3,0.9428571428571428,35
Mukdahan,Samut Sakhon,10.0,5.0,1,0,0,1,1.0,1
Mukdahan,Samut Songkhram,16.666666666666668,12.666666666666666,6,0,5,1,1.0,6
Mukdahan,Saraburi,11.436893203883495,8.825242718446601,92,11,97,6,0.8932038834951457,103
Mukdahan,Satun,2.5,0.0,2,0,2,0,1.0,2
Mukdahan,Si Sa Ket,12.659090909090908,9.452272727272728,401,39,403,37,0.9113636363636364,440
Mukdahan,Sing Buri,9.68421052631579,6.526315789473684,18,1,19,0,0.9473684210526315,19
Mukdahan,Songkhla,10.833333333333334,7.666666666666667,6,0,5,1,1.0,6
Mukdahan,Sukhothai,18.4,15.0,3,2,5,0,0.6,5
Mukdahan,Suphan Buri,5.333333333333333,3.3333333333333335,3,0,3,0,1.0,3
Mukdahan,Surat Thani,10.0,5.0,1,0,1,0,1.0,1
Mukdahan,Surin,12.068493150684931,8.794520547945206,131,15,136,10,0.8972602739726028,146
Mukdahan,Tak,11.666666666666666,7.333333333333333,2,1,3,0,0.6666666666666666,3
Mukdahan,Trang,7.666666666666667,6.0,3,0,3,0,1.0,3
Mukdahan,Trat,12.327586206896552,8.948275862068966,54,4,52,6,0.9310344827586207,58
Mukdahan,Ubon Ratchathani,11.774647887323944,8.852112676056338,131,11,130,12,0.9225352112676056,142
Mukdahan,Udon Thani,13.076923076923077,9.128205128205128,37,2,34,5,0.9487179487179487,39
Mukdahan,Uthai Thani,10.454545454545455,6.909090909090909,11,0,9,2,1.0,11
Mukdahan,Uttaradit,16.5,13.666666666666666,4,2,6,0,0.6666666666666666,6
Mukdahan,Yala,30.0,25.0,0,1,1,0,0.0,1
Mukdahan,Yasothon,11.137254901960784,8.549019607843137,47,4,47,4,0.9215686274509803,51
Nakhon Nayok,Nakhon Nayok,12.565217391304348,9.695652173913043,21,2,21,2,0.9130434782608695,23
Nakhon Nayok,Nakhon Pathom,12.545454545454545,9.636363636363637,9,2,11,0,0.8181818181818182,11
Nakhon Nayok,Nakhon Phanom,11.96,9.026666666666667,70,5,66,9,0.9333333333333333,75
Nakhon Nayok,Nakhon Ratchasima,13.991596638655462,10.184873949579831,103,16,101,18,0.865546218487395,119
Nakhon Nayok,Nakhon Sawan,9.333333333333334,6.333333333333333,15,0,12,3,1.0,15
Nakhon Nayok,Nakhon Si Thammarat,6.5,5.5,2,0,2,0,1.0,2
Nakhon Nayok,Narathiwat,24.8,18.8,3,2,3,2,0.6,5
Nakhon Nayok,Nong Khai,12.615384615384615,9.0,12,1,12,1,0.9230769230769231,13
Nakhon Nayok,Nonthaburi,12.736842105263158,3.736842105263158,13,6,11,8,0.6842105263157895,19
Nakhon Nayok,Pathum Thani,16.392857142857142,11.857142857142858,24,4,19,9,0.8571428571428571,28
Nakhon Nayok,Pattani,9.7,7.2,10,0,10,0,1.0,10
Nakhon Nayok,Phangnga,3.0,1.0,2,0,2,0,1.0,2
Nakhon Nayok,Phatthalung,6.333333333333333,4.0,3,0,3,0,1.0,3
Nakhon Nayok,Phetchaburi,15.0,12.5,2,0,2,0,1.0,2
Nakhon Nayok,Phra Nakhon Si Ayutthaya,8.826086956521738,6.478260869565218,23,0,20,3,1.0,23
Nakhon Nayok,Phrae,7.857142857142857,4.857142857142857,7,0,7,0,1.0,7
Nakhon Nayok,Phuket,10.333333333333334,6.333333333333333,3,0,2,1,1.0,3
Nakhon Nayok,Prachin Buri,12.068493150684931,8.58904109589041,70,3,71,2,0.958904109589041,73
Nakhon Nayok,Prachuap Khiri Khan,8.0,6.5,2,0,2,0,1.0,2
Nakhon Nayok,Ranong,15.5,11.333333333333334,5,1,4,2,0.8333333333333334,6
Nakhon Nayok,Ratchaburi,11.0,8.75,8,0,7,1,1.0,8
Nakhon Nayok,Rayong,14.095238095238095,10.19047619047619,19,2,19,2,0.9047619047619048,21
Nakhon Nayok,Roi Et,11.343137254901961,8.235294117647058,98,4,96,6,0.9607843137254902,102
Nakhon Nayok,Sa Kaeo,10.538461538461538,8.192307692307692,22,4,25,1,0.8461538461538461,26
Nakhon Nayok,Sakon Nakhon,11.29,8.6,96,4,92,8,0.96,100
Nakhon Nayok,Samut Prakan,9.46875,7.0,29,3,30,2,0.90625,32
Nakhon Nayok,Samut Sakhon,8.0,6.0,5,0,5,0,1.0,5
Nakhon Nayok,Samut Songkhram,5.666666666666667,2.3333333333333335,3,0,3,0,1.0,3
Nakhon Nayok,Saraburi,13.443037974683545,10.79746835443038,75,4,76,3,0.9493670886075949,79
Nakhon Nayok,Satun,18.0,15.5,2,0,2,0,1.0,2
Nakhon Nayok,Si Sa Ket,11.979452054794521,8.948630136986301,274,18,266,26,0.9383561643835616,292
Nakhon Nayok,Sing Buri,14.2,10.9,18,2,19,1,0.9,20
Nakhon Nayok,Songkhla,13.8,11.0,4,1,5,0,0.8,5
Nakhon Nayok,Sukhothai,4.666666666666667,2.0,3,0,3,0,1.0,3
Nakhon Nayok,Suphan Buri,11.666666666666666,9.333333333333334,3,0,3,0,1.0,3
Nakhon Nayok,Surat Thani,13.5,9.0,2,0,2,0,1.0,2
Nakhon Nayok,Surin,14.222222222222221,11.170370370370371,123,12,124,11,0.9111111111111111,135
Nakhon Nayok,Tak,6.0,3.5,4,0,4,0,1.0,4
Nakhon Nayok,Trang,6.0,3.5,2,0,2,0,1.0,2
Nakhon Nayok,Trat,12.9,9.58,43,7,42,8,0.86,50
Nakhon Nayok,Ubon Ratchathani,11.946808510638299,9.03191489361702,88,6,90,4,0.9361702127659575,94
Nakhon Nayok,Udon Thani,13.297872340425531,10.72340425531915,44,3,47,0,0.9361702127659575,47
Nakhon Nayok,Uthai Thani,6.625,4.25,7,1,6,2,0.875,8
Nakhon Nayok,Uttaradit,15.285714285714286,13.142857142857142,7,0,7,0,1.0,7
Nakhon Nayok,Yala,2.0,0.0,1,0,1,0,1.0,1
Nakhon Nayok,Yasothon,11.3125,8.53125,32,0,31,1,1.0,32
Nakhon Pathom,Nakhon Phanom,10.037037037037036,7.37037037037037,26,1,24,3,0.9629629629629629,27
Nakhon Pathom,Nakhon Ratchasima,12.434782608695652,8.08695652173913,41,5,35,11,0.8913043478260869,46
Nakhon Pathom,Nong Khai,13.666666666666666,12.0,8,1,9,0,0.8888888888888888,9
Nakhon Pathom,Nonthaburi,12.181818181818182,5.7272727272727275,11,0,7,4,1.0,11
Nakhon Pathom,Pathum Thani,13.0,10.666666666666666,12,3,15,0,0.8,15
Nakhon Pathom,Phra Nakhon Si Ayutthaya,11.2,8.85,17,3,20,0,0.85,20
Nakhon Pathom,Prachin Buri,11.428571428571429,8.542857142857143,33,2,34,1,0.9428571428571428,35
Nakhon Pathom,Rayong,11.133333333333333,6.0,13,2,13,2,0.8666666666666667,15
Nakhon Pathom,Roi Et,12.457142857142857,8.314285714285715,31,4,31,4,0.8857142857142857,35
Nakhon Pathom,Sa Kaeo,10.333333333333334,9.333333333333334,3,0,3,0,1.0,3
Nakhon Pathom,Sakon Nakhon,8.777777777777779,6.407407407407407,27,0,27,0,1.0,27
Nakhon Pathom,Samut Prakan,13.357142857142858,10.785714285714286,13,1,14,0,0.9285714285714286,14
Nakhon Pathom,Saraburi,10.347826086956522,7.630434782608695,44,2,42,4,0.9565217391304348,46
Nakhon Pathom,Si Sa Ket,12.111731843575418,8.318435754189943,169,10,162,17,0.9441340782122905,179
Nakhon Pathom,Sing Buri,9.428571428571429,6.571428571428571,7,0,7,0,1.0,7
Nakhon Pathom,Surin,12.763157894736842,9.078947368421053,70,6,71,5,0.9210526315789473,76
Nakhon Pathom,Trat,11.529411764705882,9.705882352941176,15,2,17,0,0.8823529411764706,17
Nakhon Pathom,Ubon Ratchathani,11.568181818181818,8.090909090909092,39,5,38,6,0.8863636363636364,44
Nakhon Pathom,Udon Thani,16.64516129032258,12.419354838709678,23,8,28,3,0.7419354838709677,31
Nakhon Pathom,Yasothon,11.3125,9.1875,15,1,16,0,0.9375,16
Nakhon Phanom,Nakhon Phanom,11.035294117647059,7.976470588235294,80,5,77,8,0.9411764705882353,85
Nakhon Phanom,Nakhon Ratchasima,11.592233009708737,8.763754045307444,283,26,294,15,0.9158576051779935,309
Nakhon Phanom,Nakhon Sawan,11.0,8.68421052631579,18,1,19,0,0.9473684210526315,19
Nakhon Phanom,Nakhon Si Thammarat,10.9375,7.8125,14,2,13,3,0.875,16
Nakhon Phanom,Narathiwat,7.75,6.75,10,2,12,0,0.8333333333333334,12
Nakhon Phanom,Nong Khai,12.358490566037736,9.150943396226415,47,6,46,7,0.8867924528301887,53
Nakhon Phanom,Nonthaburi,10.733333333333333,8.216666666666667,54,6,57,3,0.9,60
Nakhon Phanom,Pathum Thani,11.67605633802817,8.605633802816902,64,7,60,11,0.9014084507042254,71
Nakhon Phanom,Pattani,9.756756756756756,7.1891891891891895,34,3,34,3,0.918918918918919,37
Nakhon Phanom,Phangnga,9.909090909090908,7.454545454545454,11,0,11,0,1.0,11
Nakhon Phanom,Phatthalung,12.5,9.666666666666666,5,1,5,1,0.8333333333333334,6
Nakhon Phanom,Phetchaburi,12.615384615384615,9.615384615384615,11,2,12,1,0.8461538461538461,13
Nakhon Phanom,Phra Nakhon Si Ayutthaya,11.5625,8.133928571428571,99,13,90,22,0.8839285714285714,112
Nakhon Phanom,Phrae,11.263157894736842,8.263157894736842,17,2,19,0,0.8947368421052632,19
Nakhon Phanom,Phuket,12.0,10.5,5,1,6,0,0.8333333333333334,6
Nakhon Phanom,Prachin Buri,12.278350515463918,8.969072164948454,177,17,180,14,0.9123711340206185,194
Nakhon Phanom,Prachuap Khiri Khan,9.88,6.96,23,2,25,0,0.92,25
Nakhon Phanom,Ranong,14.428571428571429,11.285714285714286,6,1,7,0,0.8571428571428571,7
Nakhon Phanom,Ratchaburi,12.25,9.625,14,2,15,1,0.875,16
Nakhon Phanom,Rayong,9.987951807228916,7.216867469879518,78,5,77,6,0.9397590361445783,83
Nakhon Phanom,Roi Et,10.355828220858896,7.3496932515337425,303,23,296,30,0.9294478527607362,326
Nakhon Phanom,Sa Kaeo,11.461538461538462,8.865384615384615,47,5,50,2,0.9038461538461539,52
Nakhon Phanom,Sakon Nakhon,11.32319391634981,8.714828897338403,245,18,249,14,0.9315589353612167,263
Nakhon Phanom,Samut Prakan,14.930555555555555,12.097222222222221,67,5,68,4,0.9305555555555556,72
Nakhon Phanom,Samut Sakhon,9.625,7.75,8,0,7,1,1.0,8
Nakhon Phanom,Samut Songkhram,11.052631578947368,8.631578947368421,19,0,19,0,1.0,19
Nakhon Phanom,Saraburi,9.9,7.114285714285714,203,7,205,5,0.9666666666666667,210
Nakhon Phanom,Satun,8.76923076923077,5.6923076923076925,13,0,11,2,1.0,13
Nakhon Phanom,Si Sa Ket,11.957528957528957,8.83011583011583,718,59,707,70,0.924066924066924,777
Nakhon Phanom,Sing Buri,10.975,8.425,37,3,37,3,0.925,40
Nakhon Phanom,Songkhla,9.15,7.2,20,0,19,1,1.0,20
Nakhon Phanom,Sukhothai,13.285714285714286,10.428571428571429,7,0,7,0,1.0,7
Nakhon Phanom,Suphan Buri,14.5,9.625,6,2,6,2,0.75,8
Nakhon Phanom,Surat Thani,10.25,6.25,4,0,4,0,1.0,4
Nakhon Phanom,Surin,12.012383900928793,8.786377708978328,296,27,297,26,0.9164086687306502,323
Nakhon Phanom,Tak,11.916666666666666,9.75,10,2,11,1,0.8333333333333334,12
Nakhon Phanom,Trang,12.4,10.2,5,0,5,0,1.0,5
Nakhon Phanom,Trat,10.747474747474747,7.97979797979798,94,5,89,10,0.9494949494949495,99
Nakhon Phanom,Ubon Ratchathani,11.55921052631579,8.976973684210526,277,27,281,23,0.9111842105263158,304
Nakhon Phanom,Udon Thani,11.909090909090908,8.236363636363636,103,7,99,11,0.9363636363636364,110
Nakhon Phanom,Uthai Thani,10.217391304347826,7.173913043478261,21,2,21,2,0.9130434782608695,23
Nakhon Phanom,Uttaradit,14.333333333333334,12.0,8,1,9,0,0.8888888888888888,9
Nakhon Phanom,Yala,7.5,4.5,1,1,2,0,0.5,2
Nakhon Phanom,Yasothon,10.979591836734693,8.071428571428571,90,8,91,7,0.9183673469387755,98
Nakhon Ratchasima,Nakhon Ratchasima,12.323651452282158,8.771784232365146,222,19,207,34,0.921161825726141,241
Nakhon Ratchasima,Nakhon Sawan,12.054054054054054,7.486486486486487,34,3,33,4,0.918918918918919,37
Nakhon Ratchasima,Nakhon Si Thammarat,10.0,7.171428571428572,35,0,31,4,1.0,35
Nakhon Ratchasima,Narathiwat,9.5,5.928571428571429,13,1,13,1,0.9285714285714286,14
Nakhon Ratchasima,Nong Khai,10.452380952380953,8.202380952380953,79,5,80,4,0.9404761904761905,84
Nakhon Ratchasima,Nonthaburi,11.525641025641026,8.038461538461538,76,2,67,11,0.9743589743589743,78
Nakhon Ratchasima,Pathum Thani,13.782608695652174,9.141304347826088,77,15,74,18,0.8369565217391305,92
Nakhon Ratchasima,Pattani,10.75,7.5,70,6,66,10,0.9210526315789473,76
Nakhon Ratchasima,Phangnga,10.0,6.363636363636363,10,1,9,2,0.9090909090909091,11
Nakhon Ratchasima,Phatthalung,11.173913043478262,7.0,21,2,21,2,0.9130434782608695,23
Nakhon Ratchasima,Phetchaburi,13.782608695652174,8.608695652173912,17,6,17,6,0.7391304347826086,23
Nakhon Ratchasima,Phra Nakhon Si Ayutthaya,12.059701492537313,8.559701492537313,116,18,112,22,0.8656716417910447,134
Nakhon Ratchasima,Phrae,9.846153846153847,7.076923076923077,39,0,36,3,1.0,39
Nakhon Ratchasima,Phuket,14.714285714285714,9.428571428571429,6,1,5,2,0.8571428571428571,7
Nakhon Ratchasima,Prachin Buri,12.815126050420169,9.197478991596638,212,26,211,27,0.8907563025210085,238
Nakhon Ratchasima,Prachuap Khiri Khan,12.057142857142857,8.17142857142857,29,6,25,10,0.8285714285714286,35
Nakhon Ratchasima,Ranong,11.76,7.96,21,4,22,3,0.84,25
Nakhon Ratchasima,Ratchaburi,10.969696969696969,6.484848484848484,26,7,29,4,0.7878787878787878,33
Nakhon Ratchasima,Rayong,11.25,7.7592592592592595,101,7,99,9,0.9351851851851852,108
Nakhon Ratchasima,Roi Et,11.501730103806228,8.209342560553633,516,62,519,59,0.8927335640138409,578
Nakhon Ratchasima,Sa Kaeo,13.205128205128204,10.282051282051283,105,12,110,7,0.8974358974358975,117
Nakhon Ratchasima,Sakon Nakhon,12.588235294117647,8.96358543417367,329,28,317,40,0.9215686274509803,357
Nakhon Ratchasima,Samut Prakan,10.504672897196262,7.663551401869159,99,8,104,3,0.9252336448598131,107
Nakhon Ratchasima,Samut Sakhon,11.846153846153847,8.538461538461538,12,1,12,1,0.9230769230769231,13
Nakhon Ratchasima,Samut Songkhram,11.767441860465116,9.13953488372093,42,1,40,3,0.9767441860465116,43
Nakhon Ratchasima,Saraburi,10.419847328244275,7.465648854961832,247,15,239,23,0.9427480916030534,262
Nakhon Ratchasima,Satun,11.2,7.8,23,2,25,0,0.92,25
Nakhon Ratchasima,Si Sa Ket,12.652991452991452,9.204273504273504,1084,86,1026,144,0.9264957264957265,1170
Nakhon Ratchasima,Sing Buri,9.967213114754099,7.131147540983607,57,4,56,5,0.9344262295081968,61
Nakhon Ratchasima,Songkhla,9.685714285714285,6.742857142857143,34,1,35,0,0.9714285714285714,35
Nakhon Ratchasima,Sukhothai,14.28,11.72,23,2,23,2,0.92,25
Nakhon Ratchasima,Suphan Buri,14.857142857142858,13.142857142857142,6,1,7,0,0.8571428571428571,7
Nakhon Ratchasima,Surat Thani,8.857142857142858,6.571428571428571,7,0,6,1,1.0,7
Nakhon Ratchasima,Surin,12.226039783001807,8.735985533453889,512,41,499,54,0.9258589511754068,553
Nakhon Ratchasima,Tak,13.020833333333334,8.125,43,5,38,10,0.8958333333333334,48
Nakhon Ratchasima,Trang,15.11111111111111,11.88888888888889,9,0,9,0,1.0,9
Nakhon Ratchasima,Trat,12.40625,8.375,115,13,105,23,0.8984375,128
Nakhon Ratchasima,Ubon Ratchathani,12.034623217922608,9.232179226069247,456,35,456,35,0.9287169042769857,491
Nakhon Ratchasima,Udon Thani,12.721518987341772,8.778481012658228,150,8,146,12,0.9493670886075949,158
Nakhon Ratchasima,Uthai Thani,9.2,7.033333333333333,30,0,30,0,1.0,30
Nakhon Ratchasima,Uttaradit,13.774193548387096,10.096774193548388,28,3,26,5,0.9032258064516129,31
Nakhon Ratchasima,Yala,6.5,3.5,2,0,2,0,1.0,2
Nakhon Ratchasima,Yasothon,10.696969696969697,7.606060606060606,158,7,154,11,0.9575757575757575,165
Nakhon Sawan,Nong Khai,8.0,6.111111111111111,9,0,9,0,1.0,9
Nakhon Sawan,Nonthaburi,19.142857142857142,12.285714285714286,6,1,4,3,0.8571428571428571,7
Nakhon Sawan,Pathum Thani,14.4,9.933333333333334,12,3,12,3,0.8,15
Nakhon Sawan,Phra Nakhon Si Ayutthaya,9.517241379310345,7.448275862068965,29,0,29,0,1.0,29
Nakhon Sawan,Prachin Buri,8.371428571428572,6.314285714285714,33,2,33,2,0.9428571428571428,35
Nakhon Sawan,Rayong,11.36,7.76,25,0,23,2,1.0,25
Nakhon Sawan,Roi Et,9.581818181818182,6.090909090909091,50,5,45,10,0.9090909090909091,55
Nakhon Sawan,Sa Kaeo,6.0,4.4,5,0,5,0,1.0,5
Nakhon Sawan,Sakon Nakhon,10.9375,8.3125,15,1,16,0,0.9375,16
Nakhon Sawan,Samut Prakan,8.105263157894736,5.947368421052632,19,0,19,0,1.0,19
Nakhon Sawan,Saraburi,12.232558139534884,9.465116279069768,39,4,41,2,0.9069767441860465,43
Nakhon Sawan,Si Sa Ket,11.133689839572192,8.224598930481283,179,8,175,12,0.9572192513368984,187
Nakhon Sawan,Sing Buri,10.0,5.666666666666667,3,0,2,1,1.0,3
Nakhon Sawan,Surin,10.419354838709678,7.661290322580645,57,5,57,5,0.9193548387096774,62
Nakhon Sawan,Trat,12.863636363636363,9.363636363636363,20,2,19,3,0.9090909090909091,22
Nakhon Sawan,Ubon Ratchathani,10.089285714285714,7.571428571428571,53,3,52,4,0.9464285714285714,56
Nakhon Sawan,Udon Thani,11.054054054054054,6.351351351351352,32,5,31,6,0.8648648648648649,37
Nakhon Sawan,Yasothon,9.142857142857142,6.785714285714286,12,2,13,1,0.8571428571428571,14
Nakhon Si Thammarat,Nong Khai,12.533333333333333,9.6,14,1,13,2,0.9333333333333333,15
Nakhon Si Thammarat,Nonthaburi,10.416666666666666,8.0,12,0,12,0,1.0,12
Nakhon Si Thammarat,Pathum Thani,19.77777777777778,14.0,5,4,5,4,0.5555555555555556,9
Nakhon Si Thammarat,Phra Nakhon Si Ayutthaya,10.73076923076923,8.076923076923077,25,1,24,2,0.9615384615384616,26
Nakhon Si Thammarat,Prachin Buri,10.9375,8.6875,14,2,16,0,0.875,16
Nakhon Si Thammarat,Rayong,18.0,14.88888888888889,8,1,7,2,0.8888888888888888,9
Nakhon Si Thammarat,Roi Et,9.571428571428571,6.428571428571429,39,3,36,6,0.9285714285714286,42
Nakhon Si Thammarat,Sa Kaeo,9.5,7.375,8,0,8,0,1.0,8
Nakhon Si Thammarat,Sakon Nakhon,10.545454545454545,8.409090909090908,22,0,21,1,1.0,22
Nakhon Si Thammarat,Samut Prakan,24.11111111111111,10.5,10,8,11,7,0.5555555555555556,18
Nakhon Si Thammarat,Saraburi,12.585365853658537,9.560975609756097,38,3,39,2,0.926829268292683,41
Nakhon Si Thammarat,Si Sa Ket,11.297297297297296,8.234234234234235,108,3,104,7,0.972972972972973,111
Nakhon Si Thammarat,Sing Buri,11.333333333333334,9.333333333333334,6,0,6,0,1.0,6
Nakhon Si Thammarat,Surin,11.293103448275861,8.793103448275861,56,2,56,2,0.9655172413793104,58
Nakhon Si Thammarat,Trat,14.214285714285714,11.071428571428571,14,0,10,4,1.0,14
Nakhon Si Thammarat,Ubon Ratchathani,12.277777777777779,8.055555555555555,30,6,31,5,0.8333333333333334,36
Nakhon Si Thammarat,Udon Thani,13.458333333333334,10.458333333333334,23,1,22,2,0.9583333333333334,24
Nakhon Si Thammarat,Yasothon,7.0,4.666666666666667,12,0,11,1,1.0,12
Narathiwat,Nong Khai,14.0,12.5,4,0,4,0,1.0,4
Narathiwat,Nonthaburi,11.333333333333334,9.333333333333334,3,0,3,0,1.0,3
Narathiwat,Pathum Thani,13.625,8.125,7,1,5,3,0.875,8
Narathiwat,Phra Nakhon Si Ayutthaya,9.444444444444445,7.666666666666667,9,0,8,1,1.0,9
Narathiwat,Prachin Buri,10.533333333333333,7.533333333333333,14,1,14,1,0.9333333333333333,15
Narathiwat,Rayong,9.333333333333334,5.833333333333333,12,0,10,2,1.0,12
Narathiwat,Roi Et,8.0,4.842105263157895,17,2,17,2,0.8947368421052632,19
Narathiwat,Sa Kaeo,20.0,19.0,1,0,1,0,1.0,1
Narathiwat,Sakon Nakhon,17.666666666666668,15.25,10,2,12,0,0.8333333333333334,12
Narathiwat,Samut Prakan,9.0,7.4,5,0,5,0,1.0,5
Narathiwat,Saraburi,11.421052631578947,8.631578947368421,18,1,17,2,0.9473684210526315,19
Narathiwat,Si Sa Ket,11.756410256410257,8.987179487179487,72,6,73,5,0.9230769230769231,78
Narathiwat,Sing Buri,13.666666666666666,10.5,6,0,4,2,1.0,6
Narathiwat,Surin,11.25,8.166666666666666,22,2,22,2,0.9166666666666666,24
Narathiwat,Trat,10.642857142857142,8.857142857142858,13,1,14,0,0.9285714285714286,14
Narathiwat,Ubon Ratchathani,9.958333333333334,7.458333333333333,21,3,21,3,0.875,24
Narathiwat,Udon Thani,8.222222222222221,6.666666666666667,9,0,9,0,1.0,9
Narathiwat,Yasothon,7.6,4.6,5,0,5,0,1.0,5
Nong Khai,Nong Khai,5.0,1.0,1,0,1,0,1.0,1
Nong Khai,Nonthaburi,10.0,7.0,13,0,11,2,1.0,13
Nong Khai,Pathum Thani,12.777777777777779,10.333333333333334,8,1,8,1,0.8888888888888888,9
Nong Khai,Pattani,14.96875,10.75,31,1,28,4,0.96875,32
Nong Khai,Phangnga,10.5,5.5,4,0,3,1,1.0,4
Nong Khai,Phatthalung,10.0,6.666666666666667,6,0,6,0,1.0,6
Nong Khai,Phetchaburi,13.5,11.0,4,0,4,0,1.0,4
Nong Khai,Phra Nakhon Si Ayutthaya,11.066666666666666,8.4,14,1,13,2,0.9333333333333333,15
Nong Khai,Phrae,14.875,11.875,7,1,8,0,0.875,8
Nong Khai,Phuket,7.0,5.0,2,0,2,0,1.0,2
Nong Khai,Prachin Buri,13.542857142857143,9.857142857142858,29,6,30,5,0.8285714285714286,35
Nong Khai,Prachuap Khiri Khan,13.5,9.625,13,3,13,3,0.8125,16
Nong Khai,Ranong,16.571428571428573,15.0,5,2,7,0,0.7142857142857143,7
Nong Khai,Ratchaburi,16.473684210526315,13.0,16,3,13,6,0.8421052631578947,19
Nong Khai,Rayong,9.478260869565217,7.3478260869565215,22,1,22,1,0.9565217391304348,23
Nong Khai,Roi Et,12.631067961165048,9.436893203883495,95,8,89,14,0.9223300970873787,103
Nong Khai,Sa Kaeo,13.25,11.0,23,1,20,4,0.9583333333333334,24
Nong Khai,Sakon Nakhon,11.140350877192983,8.087719298245615,54,3,52,5,0.9473684210526315,57
Nong Khai,Samut Prakan,8.642857142857142,6.071428571428571,14,0,13,1,1.0,14
Nong Khai,Samut Sakhon,6.0,6.0,1,0,1,0,1.0,1
Nong Khai,Samut Songkhram,12.941176470588236,8.647058823529411,16,1,16,1,0.9411764705882353,17
Nong Khai,Saraburi,7.588235294117647,5.647058823529412,16,1,17,0,0.9411764705882353,17
Nong Khai,Satun,8.571428571428571,7.0,7,0,6,1,1.0,7
Nong Khai,Si Sa Ket,11.660377358490566,8.471698113207546,95,11,94,12,0.8962264150943396,106
Nong Khai,Sing Buri,8.6,5.4,5,0,4,1,1.0,5
Nong Khai,Songkhla,12.833333333333334,8.166666666666666,6,0,4,2,1.0,6
Nong Khai,Sukhothai,18.5,17.75,3,1,4,0,0.75,4
Nong Khai,Suphan Buri,8.5,4.0,4,0,3,1,1.0,4
Nong Khai,Surat Thani,13.0,9.0,2,1,2,1,0.6666666666666666,3
Nong Khai,Surin,10.794520547945206,8.10958904109589,64,9,70,3,0.8767123287671232,73
Nong Khai,Tak,16.0,14.0,2,0,2,0,1.0,2
Nong Khai,Trang,9.2,6.6,5,0,5,0,1.0,5
Nong Khai,Trat,7.764705882352941,5.352941176470588,17,0,16,1,1.0,17
Nong Khai,Ubon Ratchathani,11.927536231884059,8.753623188405797,64,5,61,8,0.927536231884058,69
Nong Khai,Udon Thani,9.733333333333333,6.733333333333333,14,1,14,1,0.9333333333333333,15
Nong Khai,Uthai Thani,10.666666666666666,8.25,12,0,11,1,1.0,12
Nong Khai,Uttaradit,16.9,13.4,10,0,10,0,1.0,10
Nong Khai,Yala,6.0,6.0,1,0,1,0,1.0,1
Nong Khai,Yasothon,14.75,11.3125,26,6,29,3,0.8125,32
Nonthaburi,Nonthaburi,6.875,4.0,8,0,7,1,1.0,8
Nonthaburi,Pathum Thani,17.22222222222222,10.0,8,1,7,2,0.8888888888888888,9
Nonthaburi,Pattani,14.3125,7.8125,15,1,12,4,0.9375,16
Nonthaburi,Phangnga,19.0,11.0,1,0,0,1,1.0,1
Nonthaburi,Phatthalung,7.5,5.5,2,0,2,0,1.0,2
Nonthaburi,Phetchaburi,10.6,6.2,9,1,8,2,0.9,10
Nonthaburi,Phra Nakhon Si Ayutthaya,9.444444444444445,6.611111111111111,17,1,16,2,0.9444444444444444,18
Nonthaburi,Phrae,12.0,7.1,10,0,10,0,1.0,10
Nonthaburi,Phuket,6.333333333333333,3.3333333333333335,2,1,2,1,0.6666666666666666,3
Nonthaburi,Prachin Buri,10.37037037037037,6.592592592592593,23,4,23,4,0.8518518518518519,27
Nonthaburi,Prachuap Khiri Khan,6.818181818181818,2.4545454545454546,10,1,10,1,0.9090909090909091,11
Nonthaburi,Ranong,4.4,2.6,5,0,5,0,1.0,5
Nonthaburi,Ratchaburi,14.076923076923077,8.76923076923077,12,1,12,1,0.9230769230769231,13
Nonthaburi,Rayong,11.153846153846153,9.23076923076923,10,3,13,0,0.7692307692307693,13
Nonthaburi,Roi Et,10.174757281553399,6.378640776699029,99,4,88,15,0.9611650485436893,103
Nonthaburi,Sa Kaeo,11.619047619047619,7.380952380952381,20,1,17,4,0.9523809523809523,21
Nonthaburi,Sakon Nakhon,14.420289855072463,10.478260869565217,57,12,61,8,0.8260869565217391,69
Nonthaburi,Samut Prakan,8.357142857142858,5.714285714285714,14,0,13,1,1.0,14
Nonthaburi,Samut Sakhon,20.0,12.666666666666666,2,1,2,1,0.6666666666666666,3
Nonthaburi,Samut Songkhram,7.75,6.5,3,1,4,0,0.75,4
Nonthaburi,Saraburi,9.96,7.2,23,2,24,1,0.92,25
Nonthaburi,Satun,12.0,6.5,2,0,2,0,1.0,2
Nonthaburi,Si Sa Ket,9.574585635359115,6.861878453038674,172,9,173,8,0.9502762430939227,181
Nonthaburi,Sing Buri,10.578947368421053,8.0,18,1,19,0,0.9473684210526315,19
Nonthaburi,Songkhla,7.166666666666667,3.5,6,0,6,0,1.0,6
Nonthaburi,Sukhothai,12.5,4.5,2,0,2,0,1.0,2
Nonthaburi,Suphan Buri,12.0,10.0,1,0,1,0,1.0,1
Nonthaburi,Surat Thani,22.0,9.0,1,2,1,2,0.3333333333333333,3
Nonthaburi,Surin,12.72463768115942,9.304347826086957,62,7,64,5,0.8985507246376812,69
Nonthaburi,Tak,11.333333333333334,10.666666666666666,3,0,3,0,1.0,3
Nonthaburi,Trang,12.5,7.0,2,0,1,1,1.0,2
Nonthaburi,Trat,19.6875,14.0625,12,4,14,2,0.75,16
Nonthaburi,Ubon Ratchathani,9.728571428571428,6.5285714285714285,65,5,66,4,0.9285714285714286,70
Nonthaburi,Udon Thani,14.379310344827585,10.448275862068966,27,2,25,4,0.9310344827586207,29
Nonthaburi,Uthai Thani,12.142857142857142,8.571428571428571,7,0,7,0,1.0,7
Nonthaburi,Uttaradit,9.88888888888889,6.777777777777778,9,0,8,1,1.0,9
Nonthaburi,Yasothon,16.685714285714287,12.514285714285714,30,5,32,3,0.8571428571428571,35
Pathum Thani,Pathum Thani,14.166666666666666,10.5,5,1,4,2,0.8333333333333334,6
Pathum Thani,Pattani,12.2,8.0,29,1,24,6,0.9666666666666667,30
Pathum Thani,Phangnga,5.333333333333333,1.6666666666666667,3,0,2,1,1.0,3
Pathum Thani,Phatthalung,10.857142857142858,6.428571428571429,6,1,6,1,0.8571428571428571,7
Pathum Thani,Phetchaburi,12.1,7.6,9,1,7,3,0.9,10
Pathum Thani,Phra Nakhon Si Ayutthaya,11.4,9.4,9,1,10,0,0.9,10
Pathum Thani,Phrae,12.75,8.875,8,0,8,0,1.0,8
Pathum Thani,Phuket,19.5,13.0,4,2,4,2,0.6666666666666666,6
Pathum Thani,Prachin Buri,11.452380952380953,8.595238095238095,40,2,38,4,0.9523809523809523,42
Pathum Thani,Prachuap Khiri Khan,12.0,9.833333333333334,12,0,11,1,1.0,12
Pathum Thani,Ranong,12.0,10.2,5,0,5,0,1.0,5
Pathum Thani,Ratchaburi,16.833333333333332,14.083333333333334,9,3,11,1,0.75,12
Pathum Thani,Rayong,19.5,15.277777777777779,12,6,12,6,0.6666666666666666,18
Pathum Thani,Roi Et,14.39622641509434,10.981132075471699,94,12,95,11,0.8867924528301887,106
Pathum Thani,Sa Kaeo,11.235294117647058,7.764705882352941,15,2,15,2,0.8823529411764706,17
Pathum Thani,Sakon Nakhon,11.039473684210526,7.618421052631579,73,3,64,12,0.9605263157894737,76
Pathum Thani,Samut Prakan,12.357142857142858,6.214285714285714,10,4,9,5,0.7142857142857143,14
Pathum Thani,Samut Sakhon,12.5,8.666666666666666,5,1,5,1,0.8333333333333334,6
Pathum Thani,Samut Songkhram,13.285714285714286,9.142857142857142,14,0,11,3,1.0,14
Pathum Thani,Saraburi,19.25,16.125,5,3,8,0,0.625,8
Pathum Thani,Satun,15.333333333333334,13.666666666666666,3,0,3,0,1.0,3
Pathum Thani,Si Sa Ket,11.703947368421053,8.717105263157896,138,14,139,13,0.9078947368421053,152
Pathum Thani,Sing Buri,12.789473684210526,10.421052631578947,19,0,18,1,1.0,19
Pathum Thani,Songkhla,14.0,7.583333333333333,11,1,7,5,0.9166666666666666,12
Pathum Thani,Sukhothai,18.0,6.5,1,1,1,1,0.5,2
Pathum Thani,Suphan Buri,14.625,9.125,6,2,6,2,0.75,8
Pathum Thani,Surat Thani,8.0,7.5,2,0,2,0,1.0,2
Pathum Thani,Surin,11.779069767441861,8.220930232558139,76,10,74,12,0.8837209302325582,86
Pathum Thani,Tak,14.9,11.1,10,0,9,1,1.0,10
Pathum Thani,Trang,10.0,6.0,2,0,2,0,1.0,2
Pathum Thani,Trat,14.935483870967742,11.451612903225806,26,5,27,4,0.8387096774193549,31
Pathum Thani,Ubon Ratchathani,12.56578947368421,9.723684210526315,67,9,69,7,0.881578947368421,76
Pathum Thani,Udon Thani,13.666666666666666,10.88888888888889,7,2,8,1,0.7777777777777778,9
Pathum Thani,Uthai Thani,15.375,11.0,14,2,14,2,0.875,16
Pathum Thani,Uttaradit,18.9,16.0,9,1,10,0,0.9,10
Pathum Thani,Yala,12.0,2.0,1,0,1,0,1.0,1
Pathum Thani,Yasothon,14.419354838709678,10.612903225806452,28,3,27,4,0.9032258064516129,31
Pattani,Phra Nakhon Si Ayutthaya,12.862068965517242,9.10344827586207,26,3,22,7,0.896551724137931,29
Pattani,Prachin Buri,11.419354838709678,8.14516129032258,60,2,58,4,0.967741935483871,62
Pattani,Rayong,11.052631578947368,7.552631578947368,35,3,32,6,0.9210526315789473,38
Pattani,Roi Et,12.4,7.7,69,11,66,14,0.8625,80
Pattani,Sa Kaeo,10.214285714285714,6.0,13,1,12,2,0.9285714285714286,14
Pattani,Sakon Nakhon,10.466666666666667,7.766666666666667,57,3,57,3,0.95,60
Pattani,Samut Prakan,14.517241379310345,10.448275862068966,27,2,27,2,0.9310344827586207,29
Pattani,Saraburi,10.805194805194805,7.935064935064935,69,8,67,10,0.8961038961038961,77
Pattani,Si Sa Ket,12.627167630057803,9.390173410404625,312,34,309,37,0.9017341040462428,346
Pattani,Sing Buri,15.357142857142858,11.25,24,4,26,2,0.8571428571428571,28
Pattani,Surin,10.305555555555555,7.090277777777778,134,10,134,10,0.9305555555555556,144
Pattani,Trat,10.5,7.65,38,2,37,3,0.95,40
Pattani,Ubon Ratchathani,11.48076923076923,8.721153846153847,92,12,97,7,0.8846153846153846,104
Pattani,Udon Thani,12.706896551724139,8.46551724137931,53,5,52,6,0.9137931034482759,58
Pattani,Yasothon,11.222222222222221,8.0,25,2,25,2,0.9259259259259259,27
Phangnga,Phra Nakhon Si Ayutthaya,9.555555555555555,7.111111111111111,9,0,9,0,1.0,9
Phangnga,Prachin Buri,16.9,13.7,8,2,9,1,0.8,10
Phangnga,Rayong,9.444444444444445,6.666666666666667,9,0,9,0,1.0,9
Phangnga,Roi Et,7.545454545454546,4.363636363636363,11,0,10,1,1.0,11
Phangnga,Sa Kaeo,15.0,11.5,2,0,2,0,1.0,2
Phangnga,Sakon Nakhon,15.5,12.5,4,0,3,1,1.0,4
Phangnga,Samut Prakan,7.5,5.5,2,0,2,0,1.0,2
Phangnga,Saraburi,8.5,6.166666666666667,12,0,11,1,1.0,12
Phangnga,Si Sa Ket,10.818181818181818,7.745454545454545,48,7,50,5,0.8727272727272727,55
Phangnga,Sing Buri,4.0,2.0,3,0,3,0,1.0,3
Phangnga,Surin,9.285714285714286,4.190476190476191,19,2,18,3,0.9047619047619048,21
Phangnga,Trat,12.5,11.5,2,0,2,0,1.0,2
Phangnga,Ubon Ratchathani,8.833333333333334,6.583333333333333,12,0,12,0,1.0,12
Phangnga,Udon Thani,9.416666666666666,4.75,12,0,12,0,1.0,12
Phangnga,Yasothon,6.375,4.5,8,0,8,0,1.0,8
Phatthalung,Phra Nakhon Si Ayutthaya,9.857142857142858,8.0,6,1,6,1,0.8571428571428571,7
Phatthalung,Prachin Buri,11.125,8.5625,15,1,16,0,0.9375,16
Phatthalung,Rayong,7.0,4.166666666666667,6,0,6,0,1.0,6
Phatthalung,Roi Et,12.208333333333334,8.416666666666666,22,2,18,6,0.9166666666666666,24
Phatthalung,Sa Kaeo,6.5,4.0,2,0,2,0,1.0,2
Phatthalung,Sakon Nakhon,7.0,4.25,7,1,7,1,0.875,8
Phatthalung,Samut Prakan,13.833333333333334,10.5,5,1,6,0,0.8333333333333334,6
Phatthalung,Saraburi,10.2,8.1,10,0,10,0,1.0,10
Phatthalung,Si Sa Ket,12.538461538461538,9.461538461538462,75,3,71,7,0.9615384615384616,78
Phatthalung,Sing Buri,4.0,3.0,1,0,1,0,1.0,1
Phatthalung,Surin,12.857142857142858,8.80952380952381,18,3,18,3,0.8571428571428571,21
Phatthalung,Trat,19.4,17.6,8,2,10,0,0.8,10
Phatthalung,Ubon Ratchathani,11.2,8.366666666666667,29,1,28,2,0.9666666666666667,30
Phatthalung,Udon Thani,7.857142857142857,4.428571428571429,7,0,6,1,1.0,7
Phatthalung,Yasothon,7.0,7.0,1,0,1,0,1.0,1
Phetchaburi,Phra Nakhon Si Ayutthaya,9.666666666666666,6.888888888888889,18,0,16,2,1.0,18
Phetchaburi,Prachin Buri,16.08695652173913,12.73913043478261,21,2,23,0,0.9130434782608695,23
Phetchaburi,Rayong,10.285714285714286,7.714285714285714,7,0,7,0,1.0,7
Phetchaburi,Roi Et,11.866666666666667,7.866666666666666,30,0,24,6,1.0,30
Phetchaburi,Sa Kaeo,12.75,12.0,4,0,4,0,1.0,4
Phetchaburi,Sakon Nakhon,13.38888888888889,11.277777777777779,15,3,17,1,0.8333333333333334,18
Phetchaburi,Samut Prakan,15.25,8.0,8,0,6,2,1.0,8
Phetchaburi,Saraburi,11.833333333333334,9.0,23,1,23,1,0.9583333333333334,24
Phetchaburi,Si Sa Ket,13.397590361445783,10.518072289156626,73,10,78,5,0.8795180722891566,83
Phetchaburi,Sing Buri,11.333333333333334,8.666666666666666,6,0,5,1,1.0,6
Phetchaburi,Surin,9.733333333333333,6.266666666666667,29,1,29,1,0.9666666666666667,30
Phetchaburi,Trat,11.692307692307692,8.538461538461538,12,1,10,3,0.9230769230769231,13
Phetchaburi,Ubon Ratchathani,9.333333333333334,7.181818181818182,32,1,31,2,0.9696969696969697,33
Phetchaburi,Udon Thani,11.956521739130435,7.869565217391305,22,1,19,4,0.9565217391304348,23
Phetchaburi,Yasothon,8.5,7.4,9,1,10,0,0.9,10
Phra Nakhon Si Ayutthaya,Phra Nakhon Si Ayutthaya,7.454545454545454,4.636363636363637,10,1,10,1,0.9090909090909091,11
Phra Nakhon Si Ayutthaya,Phrae,12.8,7.35,19,1,16,4,0.95,20
Phra Nakhon Si Ayutthaya,Phuket,12.4,8.8,5,0,3,2,1.0,5
Phra Nakhon Si Ayutthaya,Prachin Buri,10.985714285714286,7.328571428571428,63,7,61,9,0.9,70
Phra Nakhon Si Ayutthaya,Prachuap Khiri Khan,5.1,3.3,10,0,10,0,1.0,10
Phra Nakhon Si Ayutthaya,Ranong,9.266666666666667,7.6,15,0,15,0,1.0,15
Phra Nakhon Si Ayutthaya,Ratchaburi,8.666666666666666,5.428571428571429,21,0,20,1,1.0,21
Phra Nakhon Si Ayutthaya,Rayong,16.17142857142857,12.942857142857143,33,2,26,9,0.9428571428571428,35
Phra Nakhon Si Ayutthaya,Roi Et,12.034782608695652,8.156521739130435,106,9,100,15,0.9217391304347826,115
Phra Nakhon Si Ayutthaya,Sa Kaeo,12.025641025641026,8.666666666666666,37,2,34,5,0.9487179487179487,39
Phra Nakhon Si Ayutthaya,Sakon Nakhon,12.744,9.864,111,14,112,13,0.888,125
Phra Nakhon Si Ayutthaya,Samut Prakan,8.96,6.36,24,1,22,3,0.96,25
Phra Nakhon Si Ayutthaya,Samut Sakhon,4.333333333333333,1.8333333333333333,6,0,6,0,1.0,6
Phra Nakhon Si Ayutthaya,Samut Songkhram,11.15,8.05,20,0,19,1,1.0,20
Phra Nakhon Si Ayutthaya,Saraburi,8.9375,6.125,16,0,15,1,1.0,16
Phra Nakhon Si Ayutthaya,Satun,12.083333333333334,9.333333333333334,10,2,11,1,0.8333333333333334,12
Phra Nakhon Si Ayutthaya,Si Sa Ket,11.196629213483146,7.730337078651686,169,9,163,15,0.949438202247191,178
Phra Nakhon Si Ayutthaya,Sing Buri,12.153846153846153,9.615384615384615,11,2,13,0,0.8461538461538461,13
Phra Nakhon Si Ayutthaya,Songkhla,10.133333333333333,6.866666666666666,13,2,14,1,0.8666666666666667,15
Phra Nakhon Si Ayutthaya,Sukhothai,16.333333333333332,8.0,8,1,7,2,0.8888888888888888,9
Phra Nakhon Si Ayutthaya,Suphan Buri,10.0,7.3,10,0,9,1,1.0,10
Phra Nakhon Si Ayutthaya,Surat Thani,9.25,7.5,4,0,4,0,1.0,4
Phra Nakhon Si Ayutthaya,Surin,12.928571428571429,9.696428571428571,103,9,101,11,0.9196428571428571,112
Phra Nakhon Si Ayutthaya,Tak,9.615384615384615,6.615384615384615,13,0,11,2,1.0,13
Phra Nakhon Si Ayutthaya,Trang,5.4,4.2,3,2,5,0,0.6,5
Phra Nakhon Si Ayutthaya,Trat,13.46875,9.34375,29,3,27,5,0.90625,32
Phra Nakhon Si Ayutthaya,Ubon Ratchathani,13.523809523809524,10.723809523809523,95,10,97,8,0.9047619047619048,105
Phra Nakhon Si Ayutthaya,Udon Thani,11.166666666666666,7.75,12,0,11,1,1.0,12
Phra Nakhon Si Ayutthaya,Uthai Thani,14.157894736842104,8.263157894736842,17,2,16,3,0.8947368421052632,19
Phra Nakhon Si Ayutthaya,Uttaradit,13.142857142857142,7.0,7,0,5,2,1.0,7
Phra Nakhon Si Ayutthaya,Yala,14.25,11.75,3,1,4,0,0.75,4
Phra Nakhon Si Ayutthaya,Yasothon,9.787234042553191,6.595744680851064,46,1,42,5,0.9787234042553191,47
Phrae,Prachin Buri,12.4,9.65,19,1,19,1,0.95,20
Phrae,Rayong,10.9375,8.875,15,1,15,1,0.9375,16
Phrae,Roi Et,11.4,8.571428571428571,31,4,33,2,0.8857142857142857,35
Phrae,Sa Kaeo,14.75,11.25,4,0,4,0,1.0,4
Phrae,Sakon Nakhon,9.6,8.32,23,2,25,0,0.92,25
Phrae,Samut Prakan,7.0,5.538461538461538,13,0,13,0,1.0,13
Phrae,Saraburi,10.414634146341463,7.463414634146342,39,2,40,1,0.9512195121951219,41
Phrae,Si Sa Ket,12.083916083916083,9.181818181818182,135,8,131,12,0.9440559440559441,143
Phrae,Sing Buri,6.0,4.375,8,0,8,0,1.0,8
Phrae,Surin,12.628571428571428,9.742857142857142,66,4,67,3,0.9428571428571428,70
Phrae,Trat,10.411764705882353,8.0,16,1,15,2,0.9411764705882353,17
Phrae,Ubon Ratchathani,11.5,8.45,39,1,38,2,0.975,40
Phrae,Udon Thani,15.444444444444445,10.37037037037037,24,3,21,6,0.8888888888888888,27
Phrae,Yasothon,17.533333333333335,14.6,13,2,15,0,0.8666666666666667,15
Phuket,Prachin Buri,19.0,10.727272727272727,7,4,9,2,0.6363636363636364,11
Phuket,Rayong,9.285714285714286,6.571428571428571,7,0,6,1,1.0,7
Phuket,Roi Et,7.375,4.25,8,0,7,1,1.0,8
Phuket,Sa Kaeo,10.0,9.0,1,0,1,0,1.0,1
Phuket,Sakon Nakhon,10.0,8.5,6,0,6,0,1.0,6
Phuket,Samut Prakan,9.333333333333334,6.666666666666667,3,0,3,0,1.0,3
Phuket,Saraburi,13.5,10.333333333333334,6,0,6,0,1.0,6
Phuket,Si Sa Ket,11.18421052631579,8.921052631578947,37,1,36,2,0.9736842105263158,38
Phuket,Sing Buri,14.666666666666666,11.333333333333334,3,0,3,0,1.0,3
Phuket,Surin,12.0625,9.1875,14,2,15,1,0.875,16
Phuket,Trat,14.714285714285714,11.285714285714286,7,0,5,2,1.0,7
Phuket,Ubon Ratchathani,10.95,8.65,20,0,18,2,1.0,20
Phuket,Udon Thani,10.142857142857142,8.285714285714286,7,0,7,0,1.0,7
Prachin Buri,Prachin Buri,12.1,9.1,56,4,56,4,0.9333333333333333,60
Prachin Buri,Prachuap Khiri Khan,9.229166666666666,5.458333333333333,47,1,42,6,0.9791666666666666,48
Prachin Buri,Ranong,13.333333333333334,9.4,13,2,12,3,0.8666666666666667,15
Prachin Buri,Ratchaburi,12.575757575757576,9.757575757575758,30,3,29,4,0.9090909090909091,33
Prachin Buri,Rayong,12.734375,9.46875,62,2,58,6,0.96875,64
Prachin Buri,Roi Et,12.041269841269841,9.015873015873016,289,26,303,12,0.9174603174603174,315
Prachin Buri,Sa Kaeo,12.191011235955056,9.382022471910112,79,10,88,1,0.8876404494382022,89
Prachin Buri,Sakon Nakhon,12.427884615384615,9.615384615384615,188,20,195,13,0.9038461538461539,208
Prachin Buri,Samut Prakan,13.020833333333334,10.854166666666666,41,7,48,0,0.8541666666666666,48
Prachin Buri,Samut Sakhon,9.636363636363637,6.454545454545454,10,1,11,0,0.9090909090909091,11
Prachin Buri,Samut Songkhram,14.891891891891891,10.0,37,0,32,5,1.0,37
Prachin Buri,Saraburi,11.596491228070175,8.929824561403509,106,8,106,8,0.9298245614035088,114
Prachin Buri,Satun,12.875,9.75,6,2,7,1,0.75,8
Prachin Buri,Si Sa Ket,12.598790322580646,9.637096774193548,453,43,456,40,0.9133064516129032,496
Prachin Buri,Sing Buri,11.806451612903226,9.0,28,3,28,3,0.9032258064516129,31
Prachin Buri,Songkhla,16.333333333333332,13.333333333333334,11,1,12,0,0.9166666666666666,12
Prachin Buri,Sukhothai,9.333333333333334,7.0,3,0,3,0,1.0,3
Prachin Buri,Suphan Buri,17.181818181818183,13.454545454545455,8,3,10,1,0.7272727272727273,11
Prachin Buri,Surat Thani,7.0,5.666666666666667,3,0,3,0,1.0,3
Prachin Buri,Surin,12.584415584415584,9.380952380952381,213,18,214,17,0.922077922077922,231
Prachin Buri,Tak,13.35,10.15,18,2,19,1,0.9,20
Prachin Buri,Trang,13.0,9.0,9,2,9,2,0.8181818181818182,11
Prachin Buri,Trat,11.414893617021276,9.02127659574468,88,6,86,8,0.9361702127659575,94
Prachin Buri,Ubon Ratchathani,12.909774436090226,9.657894736842104,242,24,247,19,0.9097744360902256,266
Prachin Buri,Udon Thani,11.472972972972974,8.283783783783784,70,4,67,7,0.9459459459459459,74
Prachin Buri,Uthai Thani,11.514285714285714,8.6,33,2,31,4,0.9428571428571428,35
Prachin Buri,Uttaradit,11.26086956521739,7.3478260869565215,20,3,20,3,0.8695652173913043,23
Prachin Buri,Yala,8.0,7.0,1,0,1,0,1.0,1
Prachin Buri,Yasothon,12.908045977011493,10.195402298850574,78,9,84,3,0.896551724137931,87
Prachuap Khiri Khan,Rayong,7.555555555555555,3.6666666666666665,9,0,8,1,1.0,9
Prachuap Khiri Khan,Roi Et,13.842105263157896,8.157894736842104,33,5,31,7,0.868421052631579,38
Prachuap Khiri Khan,Sa Kaeo,7.25,5.0,4,0,4,0,1.0,4
Prachuap Khiri Khan,Sakon Nakhon,14.96,12.12,24,1,23,2,0.96,25
Prachuap Khiri Khan,Samut Prakan,10.636363636363637,6.545454545454546,10,1,10,1,0.9090909090909091,11
Prachuap Khiri Khan,Saraburi,11.183673469387756,8.775510204081632,44,5,48,1,0.8979591836734694,49
Prachuap Khiri Khan,Si Sa Ket,11.734104046242775,8.364161849710984,157,16,159,14,0.9075144508670521,173
Prachuap Khiri Khan,Sing Buri,6.4,4.7,10,0,10,0,1.0,10
Prachuap Khiri Khan,Surin,11.36231884057971,8.44927536231884,62,7,63,6,0.8985507246376812,69
Prachuap Khiri Khan,Trat,9.3125,7.3125,16,0,15,1,1.0,16
Prachuap Khiri Khan,Ubon Ratchathani,12.264150943396226,9.547169811320755,48,5,49,4,0.9056603773584906,53
Prachuap Khiri Khan,Udon Thani,9.761904761904763,6.428571428571429,19,2,21,0,0.9047619047619048,21
Prachuap Khiri Khan,Yasothon,12.833333333333334,7.833333333333333,6,0,5,1,1.0,6
Ranong,Rayong,9.333333333333334,7.166666666666667,6,0,6,0,1.0,6
Ranong,Roi Et,10.071428571428571,6.928571428571429,27,1,27,1,0.9642857142857143,28
Ranong,Sakon Nakhon,7.681818181818182,5.818181818181818,20,2,21,1,0.9090909090909091,22
Ranong,Samut Prakan,15.6,10.4,4,1,4,1,0.8,5
Ranong,Saraburi,10.434782608695652,8.0,21,2,22,1,0.9130434782608695,23
Ranong,Si Sa Ket,11.363636363636363,8.75,83,5,81,7,0.9431818181818182,88
Ranong,Sing Buri,8.666666666666666,6.333333333333333,3,0,3,0,1.0,3
Ranong,Surin,12.863636363636363,9.227272727272727,19,3,21,1,0.8636363636363636,22
Ranong,Trat,10.181818181818182,7.545454545454546,10,1,10,1,0.9090909090909091,11
Ranong,Ubon Ratchathani,14.222222222222221,11.666666666666666,17,1,17,1,0.9444444444444444,18
Ranong,Udon Thani,12.25,9.333333333333334,11,1,12,0,0.9166666666666666,12
Ranong,Yasothon,8.0,5.888888888888889,9,0,8,1,1.0,9
Ratchaburi,Rayong,10.0,7.3,10,0,10,0,1.0,10
Ratchaburi,Roi Et,10.372093023255815,7.116279069767442,39,4,37,6,0.9069767441860465,43
Ratchaburi,Sa Kaeo,2.0,1.0,1,0,1,0,1.0,1
Ratchaburi,Sakon Nakhon,7.5,5.458333333333333,23,1,21,3,0.9583333333333334,24
Ratchaburi,Samut Prakan,6.888888888888889,4.277777777777778,18,0,17,1,1.0,18
Ratchaburi,Saraburi,8.620689655172415,6.275862068965517,29,0,28,1,1.0,29
Ratchaburi,Si Sa Ket,13.420731707317072,9.841463414634147,146,18,138,26,0.8902439024390244,164
Ratchaburi,Sing Buri,5.545454545454546,2.6363636363636362,9,2,11,0,0.8181818181818182,11
Ratchaburi,Surin,11.737704918032787,8.688524590163935,55,6,54,7,0.9016393442622951,61
Ratchaburi,Trat,9.166666666666666,5.25,12,0,12,0,1.0,12
Ratchaburi,Ubon Ratchathani,8.657894736842104,6.157894736842105,36,2,35,3,0.9473684210526315,38
Ratchaburi,Udon Thani,9.090909090909092,5.636363636363637,22,0,20,2,1.0,22
Ratchaburi,Yasothon,8.818181818181818,7.363636363636363,11,0,11,0,1.0,11
Rayong,Rayong,13.142857142857142,10.714285714285714,6,1,6,1,0.8571428571428571,7
Rayong,Roi Et,13.564885496183207,10.183206106870228,123,8,115,16,0.9389312977099237,131
Rayong,Sa Kaeo,12.357142857142858,8.535714285714286,25,3,23,5,0.8928571428571429,28
Rayong,Sakon Nakhon,13.596491228070175,10.070175438596491,103,11,101,13,0.9035087719298246,114
Rayong,Samut Prakan,10.043478260869565,5.913043478260869,22,1,19,4,0.9565217391304348,23
Rayong,Samut Sakhon,8.166666666666666,5.833333333333333,6,0,6,0,1.0,6
Rayong,Samut Songkhram,9.9,7.3,10,0,9,1,1.0,10
Rayong,Saraburi,10.441176470588236,7.088235294117647,33,1,33,1,0.9705882352941176,34
Rayong,Satun,9.666666666666666,8.0,3,0,3,0,1.0,3
Rayong,Si Sa Ket,11.29004329004329,8.2987012987013,218,13,218,13,0.9437229437229437,231
Rayong,Sing Buri,13.05,10.3,17,3,18,2,0.85,20
Rayong,Songkhla,13.166666666666666,12.166666666666666,5,1,6,0,0.8333333333333334,6
Rayong,Sukhothai,4.0,1.6666666666666667,3,0,3,0,1.0,3
Rayong,Suphan Buri,11.0,9.4,9,1,10,0,0.9,10
Rayong,Surat Thani,5.6,3.8,10,0,10,0,1.0,10
Rayong,Surin,13.791666666666666,10.416666666666666,80,16,89,7,0.8333333333333334,96
Rayong,Tak,8.733333333333333,5.666666666666667,15,0,14,1,1.0,15
Rayong,Trang,7.25,3.75,4,0,4,0,1.0,4
Rayong,Trat,12.4,8.6,23,2,22,3,0.92,25
Rayong,Ubon Ratchathani,11.826923076923077,9.35576923076923,99,5,98,6,0.9519230769230769,104
Rayong,Udon Thani,11.105263157894736,7.2105263157894735,17,2,16,3,0.8947368421052632,19
Rayong,Uthai Thani,13.153846153846153,9.461538461538462,11,2,11,2,0.8461538461538461,13
Rayong,Uttaradit,20.11764705882353,17.529411764705884,10,7,16,1,0.5882352941176471,17
Rayong,Yala,8.0,6.0,2,0,2,0,1.0,2
Rayong,Yasothon,13.044444444444444,9.844444444444445,39,6,40,5,0.8666666666666667,45
Roi Et,Roi Et,10.398550724637682,6.916666666666667,259,17,243,33,0.9384057971014492,276
Roi Et,Sa Kaeo,11.232142857142858,7.75,104,8,103,9,0.9285714285714286,112
Roi Et,Sakon Nakhon,12.188202247191011,9.00561797752809,330,26,328,28,0.9269662921348315,356
Roi Et,Samut Prakan,9.484126984126984,6.277777777777778,121,5,114,12,0.9603174603174603,126
Roi Et,Samut Sakhon,8.1,5.6,10,0,10,0,1.0,10
Roi Et,Samut Songkhram,10.807692307692308,7.673076923076923,46,6,48,4,0.8846153846153846,52
Roi Et,Saraburi,10.706293706293707,7.905594405594406,265,21,271,15,0.9265734265734266,286
Roi Et,Satun,11.653846153846153,7.769230769230769,23,3,24,2,0.8846153846153846,26
Roi Et,Si Sa Ket,11.887432536622976,8.738627602158829,1200,97,1187,110,0.9252120277563608,1297
Roi Et,Sing Buri,11.608108108108109,9.08108108108108,70,4,70,4,0.9459459459459459,74
Roi Et,Songkhla,11.4375,8.3125,32,0,29,3,1.0,32
Roi Et,Sukhothai,11.529411764705882,8.647058823529411,16,1,17,0,0.9411764705882353,17
Roi Et,Suphan Buri,14.363636363636363,11.909090909090908,8,3,11,0,0.7272727272727273,11
Roi Et,Surat Thani,13.5,9.6,10,0,8,2,1.0,10
Roi Et,Surin,11.63953488372093,8.307308970099667,563,39,553,49,0.9352159468438538,602
Roi Et,Tak,11.263157894736842,6.815789473684211,36,2,30,8,0.9473684210526315,38
Roi Et,Trang,7.090909090909091,4.454545454545454,11,0,9,2,1.0,11
Roi Et,Trat,10.694610778443113,7.538922155688622,158,9,153,14,0.9461077844311377,167
Roi Et,Ubon Ratchathani,11.02626641651032,8.24577861163227,505,28,498,35,0.9474671669793621,533
Roi Et,Udon Thani,11.253886010362693,8.238341968911918,173,20,182,11,0.8963730569948186,193
Roi Et,Uthai Thani,11.514285714285714,7.142857142857143,32,3,30,5,0.9142857142857143,35
Roi Et,Uttaradit,9.826086956521738,6.565217391304348,23,0,19,4,1.0,23
Roi Et,Yala,10.0,3.0,1,0,0,1,1.0,1
Roi Et,Yasothon,11.365384615384615,8.48076923076923,142,14,144,12,0.9102564102564102,156
Sa Kaeo,Sa Kaeo,6.857142857142857,5.142857142857143,7,0,7,0,1.0,7
Sa Kaeo,Sakon Nakhon,10.3625,7.3125,77,3,72,8,0.9625,80
Sa Kaeo,Samut Prakan,11.238095238095237,6.666666666666667,20,1,20,1,0.9523809523809523,21
Sa Kaeo,Samut Songkhram,5.0,2.0,2,0,2,0,1.0,2
Sa Kaeo,Saraburi,10.914634146341463,8.634146341463415,79,3,77,5,0.9634146341463414,82
Sa Kaeo,Satun,6.0,4.5,2,0,2,0,1.0,2
Sa Kaeo,Si Sa Ket,13.284848484848485,10.06969696969697,298,32,294,36,0.9030303030303031,330
Sa Kaeo,Sing Buri,14.375,12.5,7,1,7,1,0.875,8
Sa Kaeo,Songkhla,8.333333333333334,8.333333333333334,3,0,3,0,1.0,3
Sa Kaeo,Sukhothai,15.666666666666666,12.333333333333334,3,0,3,0,1.0,3
Sa Kaeo,Surat Thani,7.0,5.666666666666667,3,0,3,0,1.0,3
Sa Kaeo,Surin,12.142857142857142,9.084415584415584,141,13,142,12,0.9155844155844156,154
Sa Kaeo,Tak,11.0,7.0,3,0,2,1,1.0,3
Sa Kaeo,Trat,13.482758620689655,9.586206896551724,25,4,22,7,0.8620689655172413,29
Sa Kaeo,Ubon Ratchathani,12.008547008547009,9.290598290598291,108,9,112,5,0.9230769230769231,117
Sa Kaeo,Udon Thani,10.333333333333334,7.826086956521739,67,2,68,1,0.9710144927536232,69
Sa Kaeo,Uthai Thani,13.333333333333334,10.0,3,0,3,0,1.0,3
Sa Kaeo,Uttaradit,12.5,10.0,4,0,4,0,1.0,4
Sa Kaeo,Yala,13.0,11.0,1,0,1,0,1.0,1
Sa Kaeo,Yasothon,11.675675675675675,9.08108108108108,35,2,37,0,0.9459459459459459,37
Sakon Nakhon,Sakon Nakhon,11.631205673758865,9.198581560283689,129,12,133,8,0.9148936170212766,141
Sakon Nakhon,Samut Prakan,12.158536585365853,9.158536585365853,76,6,77,5,0.926829268292683,82
Sakon Nakhon,Samut Sakhon,7.8,5.8,5,0,5,0,1.0,5
Sakon Nakhon,Samut Songkhram,10.894736842105264,8.947368421052632,35,3,38,0,0.9210526315789473,38
Sakon Nakhon,Saraburi,12.122641509433961,9.278301886792454,194,18,195,17,0.9150943396226415,212
Sakon Nakhon,Satun,13.0,10.0,12,1,11,2,0.9230769230769231,13
Sakon Nakhon,Si Sa Ket,12.444227005870841,9.268101761252446,927,95,929,93,0.9070450097847358,1022
Sakon Nakhon,Sing Buri,11.535714285714286,8.928571428571429,54,2,53,3,0.9642857142857143,56
Sakon Nakhon,Songkhla,18.0,13.2,8,2,9,1,0.8,10
Sakon Nakhon,Sukhothai,11.0,7.8,5,0,4,1,1.0,5
Sakon Nakhon,Suphan Buri,12.5,10.1,9,1,10,0,0.9,10
Sakon Nakhon,Surat Thani,10.583333333333334,7.416666666666667,10,2,9,3,0.8333333333333334,12
Sakon Nakhon,Surin,12.491379310344827,9.495689655172415,426,38,432,32,0.9181034482758621,464
Sakon Nakhon,Tak,9.944444444444445,6.833333333333333,17,1,17,1,0.9444444444444444,18
Sakon Nakhon,Trang,13.777777777777779,10.11111111111111,8,1,8,1,0.8888888888888888,9
Sakon Nakhon,Trat,12.624113475177305,9.453900709219859,128,13,122,19,0.9078014184397163,141
Sakon Nakhon,Ubon Ratchathani,11.389333333333333,8.36,356,19,346,29,0.9493333333333334,375
Sakon Nakhon,Udon Thani,12.255172413793103,8.317241379310344,138,7,132,13,0.9517241379310345,145
Sakon Nakhon,Uthai Thani,20.045454545454547,17.772727272727273,20,2,19,3,0.9090909090909091,22
Sakon Nakhon,Uttaradit,10.047619047619047,7.190476190476191,20,1,20,1,0.9523809523809523,21
Sakon Nakhon,Yala,3.0,1.0,1,0,1,0,1.0,1
Sakon Nakhon,Yasothon,11.964285714285714,9.142857142857142,99,13,106,6,0.8839285714285714,112
Samut Prakan,Samut Prakan,11.4,7.1,9,1,9,1,0.9,10
Samut Prakan,Samut Sakhon,4.4,1.0,4,1,4,1,0.8,5
Samut Prakan,Samut Songkhram,9.0,6.368421052631579,19,0,18,1,1.0,19
Samut Prakan,Saraburi,12.617647058823529,8.5,33,1,30,4,0.9705882352941176,34
Samut Prakan,Satun,18.0,12.666666666666666,3,0,3,0,1.0,3
Samut Prakan,Si Sa Ket,10.436018957345972,7.5260663507109005,198,13,191,20,0.9383886255924171,211
Samut Prakan,Sing Buri,10.692307692307692,7.846153846153846,13,0,12,1,1.0,13
Samut Prakan,Songkhla,10.285714285714286,6.714285714285714,7,0,6,1,1.0,7
Samut Prakan,Sukhothai,13.0,12.0,2,0,2,0,1.0,2
Samut Prakan,Suphan Buri,12.5,9.0,4,0,4,0,1.0,4
Samut Prakan,Surat Thani,6.428571428571429,3.142857142857143,7,0,6,1,1.0,7
Samut Prakan,Surin,9.308510638297872,6.340425531914893,89,5,85,9,0.9468085106382979,94
Samut Prakan,Tak,11.0,6.777777777777778,8,1,9,0,0.8888888888888888,9
Samut Prakan,Trang,11.8,9.4,5,0,5,0,1.0,5
Samut Prakan,Trat,12.290322580645162,8.935483870967742,29,2,28,3,0.9354838709677419,31
Samut Prakan,Ubon Ratchathani,9.403846153846153,6.721153846153846,101,3,98,6,0.9711538461538461,104
Samut Prakan,Udon Thani,10.130434782608695,7.0,21,2,20,3,0.9130434782608695,23
Samut Prakan,Uthai Thani,12.6875,10.9375,16,0,15,1,1.0,16
Samut Prakan,Uttaradit,7.833333333333333,6.833333333333333,6,0,6,0,1.0,6
Samut Prakan,Yasothon,10.638297872340425,8.23404255319149,44,3,45,2,0.9361702127659575,47
Samut Sakhon,Saraburi,9.833333333333334,6.583333333333333,11,1,11,1,0.9166666666666666,12
Samut Sakhon,Si Sa Ket,10.764705882352942,8.215686274509803,50,1,47,4,0.9803921568627451,51
Samut Sakhon,Sing Buri,9.333333333333334,7.0,4,2,6,0,0.6666666666666666,6
Samut Sakhon,Surin,13.904761904761905,9.761904761904763,20,1,20,1,0.9523809523809523,21
Samut Sakhon,Trat,6.0,4.714285714285714,7,0,7,0,1.0,7
Samut Sakhon,Ubon Ratchathani,13.192307692307692,7.461538461538462,16,10,16,10,0.6153846153846154,26
Samut Sakhon,Udon Thani,18.0,15.75,3,1,4,0,0.75,4
Samut Sakhon,Yasothon,4.75,3.5,8,0,8,0,1.0,8
Samut Songkhram,Saraburi,12.235294117647058,9.411764705882353,31,3,32,2,0.9117647058823529,34
Samut Songkhram,Si Sa Ket,11.419354838709678,8.477419354838709,141,14,140,15,0.9096774193548387,155
Samut Songkhram,Sing Buri,14.714285714285714,13.0,6,1,7,0,0.8571428571428571,7
Samut Songkhram,Surin,11.618421052631579,8.368421052631579,74,2,70,6,0.9736842105263158,76
Samut Songkhram,Trat,11.571428571428571,9.285714285714286,13,1,14,0,0.9285714285714286,14
Samut Songkhram,Ubon Ratchathani,10.979591836734693,8.244897959183673,46,3,46,3,0.9387755102040817,49
Samut Songkhram,Udon Thani,9.823529411764707,6.823529411764706,17,0,16,1,1.0,17
Samut Songkhram,Yasothon,12.625,9.625,7,1,8,0,0.875,8
Saraburi,Saraburi,12.058823529411764,10.058823529411764,16,1,17,0,0.9411764705882353,17
Saraburi,Satun,13.0,10.714285714285714,11,3,14,0,0.7857142857142857,14
Saraburi,Si Sa Ket,11.399239543726235,8.532319391634982,248,15,237,26,0.9429657794676806,263
Saraburi,Sing Buri,14.0,11.055555555555555,14,4,15,3,0.7777777777777778,18
Saraburi,Songkhla,11.114285714285714,8.8,32,3,34,1,0.9142857142857143,35
Saraburi,Sukhothai,9.4,6.8,20,0,19,1,1.0,20
Saraburi,Suphan Buri,12.133333333333333,9.333333333333334,13,2,15,0,0.8666666666666667,15
Saraburi,Surat Thani,15.125,13.25,8,0,8,0,1.0,8
Saraburi,Surin,12.464864864864865,9.72972972972973,166,19,176,9,0.8972972972972973,185
Saraburi,Tak,11.1875,8.59375,29,3,29,3,0.90625,32
Saraburi,Trang,3.8421052631578947,2.210526315789474,19,0,19,0,1.0,19
Saraburi,Trat,11.87012987012987,9.545454545454545,74,3,76,1,0.961038961038961,77
Saraburi,Ubon Ratchathani,12.316037735849056,9.650943396226415,198,14,200,12,0.9339622641509434,212
Saraburi,Udon Thani,9.8,7.3428571428571425,34,1,34,1,0.9714285714285714,35
Saraburi,Uthai Thani,12.657142857142857,10.457142857142857,32,3,33,2,0.9142857142857143,35
Saraburi,Uttaradit,9.344827586206897,7.172413793103448,29,0,28,1,1.0,29
Saraburi,Yala,8.75,7.0,4,0,4,0,1.0,4
Saraburi,Yasothon,10.618556701030927,7.989690721649485,89,8,93,4,0.9175257731958762,97
Satun,Si Sa Ket,11.11111111111111,7.9523809523809526,59,4,54,9,0.9365079365079365,63
Satun,Sing Buri,8.5,8.0,2,0,2,0,1.0,2
Satun,Surin,13.1,10.95,18,2,20,0,0.9,20
Satun,Trat,4.4,3.8,5,0,5,0,1.0,5
Satun,Ubon Ratchathani,9.0,6.0,14,2,16,0,0.875,16
Satun,Udon Thani,9.8,2.0,5,0,4,1,1.0,5
Satun,Yasothon,9.0,7.0,2,0,2,0,1.0,2
Si Sa Ket,Si Sa Ket,12.927696078431373,9.737745098039216,734,82,755,61,0.8995098039215687,816
Si Sa Ket,Sing Buri,14.413461538461538,11.60576923076923,92,12,94,10,0.8846153846153846,104
Si Sa Ket,Songkhla,14.490384615384615,11.509615384615385,93,11,96,8,0.8942307692307693,104
Si Sa Ket,Sukhothai,12.701754385964913,9.403508771929825,51,6,54,3,0.8947368421052632,57
Si Sa Ket,Suphan Buri,14.59016393442623,11.081967213114755,56,5,58,3,0.9180327868852459,61
Si Sa Ket,Surat Thani,12.117647058823529,9.794117647058824,30,4,32,2,0.8823529411764706,34
Si Sa Ket,Surin,12.178026449643948,9.025432349949135,897,86,901,82,0.9125127161749745,983
Si Sa Ket,Tak,11.634782608695652,8.991304347826087,109,6,104,11,0.9478260869565217,115
Si Sa Ket,Trang,10.476190476190476,7.476190476190476,59,4,60,3,0.9365079365079365,63
Si Sa Ket,Trat,13.364238410596027,10.403973509933774,276,26,279,23,0.9139072847682119,302
Si Sa Ket,Ubon Ratchathani,12.397691500524658,9.203567681007344,876,77,875,78,0.919202518363064,953
Si Sa Ket,Udon Thani,13.6,9.64864864864865,170,15,165,20,0.918918918918919,185
Si Sa Ket,Uthai Thani,13.474358974358974,10.032051282051283,141,15,139,17,0.9038461538461539,156
Si Sa Ket,Uttaradit,12.826086956521738,9.478260869565217,104,11,105,10,0.9043478260869565,115
Si Sa Ket,Yala,8.692307692307692,6.384615384615385,13,0,12,1,1.0,13
Si Sa Ket,Yasothon,12.115294117647059,8.99529411764706,389,36,390,35,0.9152941176470588,425
Sing Buri,Sing Buri,5.0,4.0,1,0,1,0,1.0,1
Sing Buri,Songkhla,10.428571428571429,7.428571428571429,7,0,6,1,1.0,7
Sing Buri,Sukhothai,11.857142857142858,9.428571428571429,5,2,7,0,0.7142857142857143,7
Sing Buri,Suphan Buri,28.0,10.0,0,5,0,5,0.0,5
Sing Buri,Surat Thani,10.571428571428571,6.071428571428571,14,0,14,0,1.0,14
Sing Buri,Surin,12.586206896551724,10.258620689655173,53,5,52,6,0.9137931034482759,58
Sing Buri,Tak,7.166666666666667,4.666666666666667,6,0,6,0,1.0,6
Sing Buri,Trang,16.333333333333332,12.666666666666666,2,1,3,0,0.6666666666666666,3
Sing Buri,Trat,13.705882352941176,11.294117647058824,16,1,17,0,0.9411764705882353,17
Sing Buri,Ubon Ratchathani,15.893617021276595,12.659574468085106,42,5,43,4,0.8936170212765957,47
Sing Buri,Udon Thani,9.8,6.1,10,0,10,0,1.0,10
Sing Buri,Uthai Thani,8.166666666666666,5.916666666666667,11,1,11,1,0.9166666666666666,12
Sing Buri,Uttaradit,12.636363636363637,9.818181818181818,10,1,11,0,0.9090909090909091,11
Sing Buri,Yasothon,14.0,11.192307692307692,24,2,25,1,0.9230769230769231,26
Songkhla,Surin,11.26086956521739,7.717391304347826,44,2,44,2,0.9565217391304348,46
Songkhla,Trat,14.625,10.75,7,1,7,1,0.875,8
Songkhla,Ubon Ratchathani,7.896551724137931,5.827586206896552,29,0,29,0,1.0,29
Songkhla,Udon Thani,11.125,8.625,15,1,16,0,0.9375,16
Songkhla,Yasothon,11.294117647058824,9.529411764705882,16,1,16,1,0.9411764705882353,17
Sukhothai,Surin,13.0,8.333333333333334,22,2,22,2,0.9166666666666666,24
Sukhothai,Trat,10.777777777777779,8.555555555555555,9,0,8,1,1.0,9
Sukhothai,Ubon Ratchathani,8.933333333333334,7.2,29,1,28,2,0.9666666666666667,30
Sukhothai,Udon Thani,9.4,6.5,10,0,10,0,1.0,10
Sukhothai,Yasothon,15.076923076923077,11.615384615384615,12,1,12,1,0.9230769230769231,13
Suphan Buri,Surin,11.0,8.17142857142857,32,3,33,2,0.9142857142857143,35
Suphan Buri,Trat,6.5,4.0,7,1,7,1,0.875,8
Suphan Buri,Ubon Ratchathani,9.578947368421053,7.2631578947368425,18,1,18,1,0.9473684210526315,19
Suphan Buri,Udon Thani,15.166666666666666,10.833333333333334,6,0,6,0,1.0,6
Suphan Buri,Yasothon,26.0,25.0,1,1,2,0,0.5,2
Surat Thani,Surin,12.277777777777779,9.277777777777779,14,4,17,1,0.7777777777777778,18
Surat Thani,Trat,11.666666666666666,7.666666666666667,12,0,9,3,1.0,12
Surat Thani,Ubon Ratchathani,11.956521739130435,8.130434782608695,22,1,21,2,0.9565217391304348,23
Surat Thani,Udon Thani,13.0,10.428571428571429,6,1,7,0,0.8571428571428571,7
Surat Thani,Yasothon,7.0,5.8,5,0,5,0,1.0,5
Surin,Surin,11.777777777777779,8.657777777777778,206,19,210,15,0.9155555555555556,225
Surin,Tak,11.73076923076923,7.403846153846154,50,2,49,3,0.9615384615384616,52
Surin,Trang,7.933333333333334,5.333333333333333,15,0,15,0,1.0,15
Surin,Trat,12.642045454545455,9.613636363636363,160,16,162,14,0.9090909090909091,176
Surin,Ubon Ratchathani,12.61587982832618,9.517167381974248,428,38,433,33,0.9184549356223176,466
Surin,Udon Thani,12.417910447761194,8.626865671641792,125,9,120,14,0.9328358208955224,134
Surin,Uthai Thani,13.611940298507463,9.671641791044776,62,5,60,7,0.9253731343283582,67
Surin,Uttaradit,10.943396226415095,7.867924528301887,51,2,47,6,0.9622641509433962,53
Surin,Yala,12.0,8.0,1,0,1,0,1.0,1
Surin,Yasothon,11.087179487179487,8.143589743589743,181,14,179,16,0.9282051282051282,195
Tak,Trat,11.5,7.6875,16,0,13,3,1.0,16
Tak,Ubon Ratchathani,11.821428571428571,7.892857142857143,24,4,25,3,0.8571428571428571,28
Tak,Udon Thani,12.823529411764707,8.705882352941176,17,0,15,2,1.0,17
Tak,Yasothon,10.2,8.4,5,0,5,0,1.0,5
Trang,Trat,3.5,3.0,2,0,2,0,1.0,2
Trang,Ubon Ratchathani,5.2727272727272725,2.6363636363636362,11,0,10,1,1.0,11
Trang,Udon Thani,13.416666666666666,9.5,10,2,11,1,0.8333333333333334,12
Trang,Yasothon,3.0,1.0,1,0,1,0,1.0,1
Trat,Trat,14.32,11.24,20,5,24,1,0.8,25
Trat,Ubon Ratchathani,11.657142857142857,8.478571428571428,128,12,131,9,0.9142857142857143,140
Trat,Udon Thani,16.18421052631579,10.736842105263158,33,5,32,6,0.868421052631579,38
Trat,Uthai Thani,11.6875,8.9375,16,0,16,0,1.0,16
Trat,Uttaradit,14.88888888888889,6.222222222222222,16,2,17,1,0.8888888888888888,18
Trat,Yasothon,11.75438596491228,8.736842105263158,48,9,50,7,0.8421052631578947,57
Ubon Ratchathani,Ubon Ratchathani,9.902439024390244,7.463414634146342,192,13,194,11,0.9365853658536586,205
Ubon Ratchathani,Udon Thani,13.099173553719009,8.834710743801653,114,7,106,15,0.9421487603305785,121
Ubon Ratchathani,Uthai Thani,11.722222222222221,9.37037037037037,50,4,48,6,0.9259259259259259,54
Ubon Ratchathani,Uttaradit,9.938775510204081,7.612244897959184,47,2,49,0,0.9591836734693877,49
Ubon Ratchathani,Yala,7.75,5.5,4,0,4,0,1.0,4
Ubon Ratchathani,Yasothon,8.784431137724551,6.281437125748503,160,7,158,9,0.9580838323353293,167
Udon Thani,Udon Thani,16.0,13.222222222222221,8,1,9,0,0.8888888888888888,9
Udon Thani,Uthai Thani,13.84375,10.71875,29,3,28,4,0.90625,32
Udon Thani,Uttaradit,10.666666666666666,7.5,17,1,17,1,0.9444444444444444,18
Udon Thani,Yala,13.0,8.0,3,0,3,0,1.0,3
Udon Thani,Yasothon,13.402985074626866,9.925373134328359,63,4,59,8,0.9402985074626866,67
Uthai Thani,Yasothon,11.55,9.45,18,2,17,3,0.9,20
Uttaradit,Yasothon,11.0,9.2,9,1,10,0,0.9,10
Yala,Yasothon,9.0,8.333333333333334,3,0,3,0,1.0,3
Yasothon,Yasothon,13.31578947368421,10.578947368421053,17,2,18,1,0.8947368421052632,19
